Imperfective	Perfective
завозить	завезти
навозить	навезти
обвозить	обвезти
ввозить	ввезти
подвозить	подвезти
перевозить	перевезти
развозить	развезти
развозить	развезти
взвозить	взвезти
привозить	привезти
довозить	довезти
провозить	провезти
свозить	свезти
отвозить	отвезти
увозить	увезти
вывозить	вывезти
вылезать	вылезти
заползать	заползти
наползать	наползти
обползать	обползти
вползать	вползти
подползать	подползти
переползать	переползти
приползать	приползти
оползать	оползти
оползать	оползти
доползать	доползти
проползать	проползти
сползать	сползти
всползать	всползти
отползать	отползти
уползать	уползти
выползать	выползти
заходить	зайти
находить	найти
переходить	перейти
преходить	прейти
приходить	прийти
обходить	обойти
входить	войти
доходить	дойти
подходить	подойти
всходить	взойти
превосходить	превзойти
исходить	изойти
нисходить	низойти
снисходить	снизойти
происходить	произойти
проходить	пройти
сходить	сойти
отходить	отойти
уходить	уйти
выходить	выйти
запасать	запасти
напасать	напасти
припасать	припасти
спасать	спасти
выпасать	выпасти
зарастать	зарасти
нарастать	нарасти
обрастать	обрасти
врастать	врасти
надрастать	надрасти
подрастать	подрасти
перерастать	перерасти
взрастать	взрасти
произрастать	произрасти
возрастать	возрасти
прирастать	прирасти
дорастать	дорасти
порастать	порасти
прорастать	прорасти
отрастать	отрасти
вырастать	вырасти
заводить	завести
обзаводить	обзавести
наводить	навести
обводить	обвести
вводить	ввести
подводить	подвести
переводить	перевести
разводить	развести
взводить	взвести
изводить	извести
низводить	низвести
производить	произвести
перепроизводить	перепроизвести
воспроизводить	воспроизвести
возводить	возвести
приводить	привести
доводить	довести
поводить	повести
проводить	провести
сводить	свести
рассветать	рассвести
отводить	отвести
уводить	увести
зацветать	зацвести
доцветать	доцвести
процветать	процвести
расцветать	расцвести
отцветать	отцвести
выцветать	выцвести
выводить	вывести
заплетать	заплести
наплетать	наплести
вплетать	вплести
подплетать	подплести
переплетать	переплести
приплетать	приплести
оплетать	оплести
доплетать	доплести
проплетать	проплести
сплетать	сплести
расплетать	расплести
отплетать	отплести
уплетать	уплести
выплетать	выплести
заметать	замести
наметать	намести
обметать	обмести
вметать	вмести
подметать	подмести
переметать	перемести
разметать	размести
взметать	взмести
приметать	примести
дометать	домести
прометать	промести
сметать	смести
отметать	отмести
уметать	умести
выметать	вымести
заносить	занести
наносить	нанести
обносить	обнести
вносить	внести
привносить	привнести
нагнетать	нагнести
пригнетать	пригнести
сгнетать	сгнести
угнетать	угнести
подносить	поднести
преподносить	преподнести
переносить	перенести
разносить	разнести
взносить	взнести
произносить	произнести
возносить	вознести
превозносить	превознести
приносить	принести
доносить	донести
проносить	пронести
сносить	снести
относить	отнести
соотносить	соотнести
уносить	унести
выносить	вынести
забредать	забрести
набредать	набрести
подбредать	подбрести
перебредать	перебрести
взбредать	взбрести
прибредать	прибрести
обретать	обрести
добредать	добрести
изобретать	изобрести
приобретать	приобрести
сбредать	сбрести
выбредать	выбрести
загребать	загрести
нагребать	нагрести
подгребать	подгрести
перегребать	перегрести
разгребать	разгрести
пригребать	пригрести
огребать	огрести
догребать	догрести
погребать	погрести
прогребать	прогрести
сгребать	сгрести
отгребать	отгрести
угребать	угрести
выгребать	выгрести
наскребывать	наскрести
подскребывать	подскрести
оскребывать	оскрести
доскребывать	доскрести
проскребывать	проскрести
соскребывать	соскрести
отскребывать	отскрести
выскребывать	выскрести
соблюдать	соблюсти
натрясать	натрясти
обтрясать	обтрясти
перетрясать	перетрясти
отрясать	отрясти
потрясать	потрясти
протрясать	протрясти
сотрясать	сотрясти
стрясать	стрясти
растрясать	растрясти
оттрясать	оттрясти
утрясать	утрясти
вытрясать	вытрясти
сползаться	сползтись
расползаться	расползтись
отверзаться	отверзтись
заходиться	зайтись
находиться	найтись
приходиться	прийтись
обходиться	обойтись
расходиться	разойтись
прохаживаться	пройтись
сходиться	сойтись
запасаться	запастись
напасаться	напастись
припасаться	припастись
спасаться	спастись
разрастаться	разрастись
срастаться	срастись
заводиться	завестись
обзаводиться	обзавестись
переводиться	перевестись
разводиться	развестись
взводиться	взвестись
изводиться	известись
воспроизводиться	воспроизвестись
приводиться	привестись
доводиться	довестись
сводиться	свестись
выводиться	вывестись
заплетаться	заплестись
вплетаться	вплестись
переплетаться	переплестись
приплетаться	приплестись
доплетаться	доплестись
сплетаться	сплестись
расплетаться	расплестись
отплетаться	отплестись
выплетаться	выплестись
выметаться	выместись
заноситься	занестись
вноситься	внестись
подноситься	поднестись
переноситься	перенестись
разноситься	разнестись
взноситься	взнестись
возноситься	вознестись
превозноситься	превознестись
приноситься	принестись
доноситься	донестись
проноситься	пронестись
сноситься	снестись
относиться	отнестись
уноситься	унестись
выноситься	вынестись
разбредаться	разбрестись
сбредаться	сбрестись
подгребаться	подгрестись
пригребаться	пригрестись
огребаться	огрестись
сгребаться	сгрестись
отгребаться	отгрестись
выгребаться	выгрестись
доскребываться	доскрестись
отрясаться	отрястись
потрясаться	потрястись
сотрясаться	сотрястись
стрясаться	стрястись
растрясаться	растрястись
утрясаться	утрястись
вытрясаться	вытрястись
дохлебывать	дохлебать
схлебывать	схлебать
расхлебывать	расхлебать
отхлебывать	отхлебать
выхлебывать	выхлебать
расхлябывать	расхлябать
нажевывать	нажевать
обжевывать	обжевать
намежевывать	намежевать
обмежевывать	обмежевать
перемежевывать	перемежевать
размежевывать	размежевать
примежевывать	примежевать
отмежевывать	отмежевать
вымежевывать	вымежевать
пережевывать	пережевать
разжевывать	разжевать
изжевывать	изжевать
дожевывать	дожевать
прожевывать	прожевать
сжевывать	сжевать
отжевывать	отжевать
раскряжевывать	раскряжевать
прозевывать	прозевать
замалевывать	замалевать
намалевывать	намалевать
подмалевывать	подмалевать
перемалевывать	перемалевать
размалевывать	размалевать
измалевывать	измалевать
вымалевывать	вымалевать
заблевывать	заблевать
изблевывать	изблевать
облевывать	облевать
сблевывать	сблевать
выблевывать	выблевать
заштемпелевывать	заштемпелевать
перештемпелевывать	перештемпелевать
проштемпелевывать	проштемпелевать
заклевывать	заклевать
наклевывать	наклевать
зашпаклевывать	зашпаклевать
подшпаклевывать	подшпаклевать
прошпаклевывать	прошпаклевать
обклевывать	обклевать
подклевывать	подклевать
оклевывать	оклевать
доклевывать	доклевать
проклевывать	проклевать
склевывать	склевать
расклевывать	расклевать
исклевывать	исклевать
отклевывать	отклевать
выклевывать	выклевать
заплевывать	заплевать
оплевывать	оплевать
исплевывать	исплевать
выплевывать	выплевать
завоевывать	завоевать
отвоевывать	отвоевать
облицовывать	облицевать
перелицовывать	перелицевать
перетанцовывать	перетанцевать
дотанцовывать	дотанцевать
вытанцовывать	вытанцевать
освинцовывать	освинцевать
заторцовывать	заторцевать
приторцовывать	приторцевать
развальцовывать	развальцевать
закольцовывать	закольцевать
окольцовывать	окольцевать
перекочевывать	перекочевать
прикочевывать	прикочевать
откочевывать	откочевать
укочевывать	укочевать
накорчевывать	накорчевать
раскорчевывать	раскорчевать
выкорчевывать	выкорчевать
затушевывать	затушевать
подтушевывать	подтушевать
перетушевывать	перетушевать
дотушевывать	дотушевать
стушевывать	стушевать
растушевывать	растушевать
оттушевывать	оттушевать
зазывать	зазвать
называть	назвать
взывать	воззвать
призывать	призвать
обзывать	обозвать
подзывать	подозвать
прозывать	прозвать
сзывать	созвать
созывать	созвать
отзывать	отозвать
вызывать	вызвать
затрамбовывать	затрамбовать
втрамбовывать	втрамбовать
утрамбовывать	утрамбовать
вытрамбовывать	вытрамбовать
завербовывать	завербовать
навербовывать	навербовать
перевербовывать	перевербовать
облюбовывать	облюбовать
обмозговывать	обмозговать
нашпиговывать	нашпиговать
прошпиговывать	прошпиговать
заинтриговывать	заинтриговать
запеленговывать	запеленговать
заторговывать	заторговать
наторговывать	наторговать
подторговывать	подторговать
приторговывать	приторговать
проторговывать	проторговать
сторговывать	сторговать
расторговывать	расторговать
отторговывать	отторговать
выторговывать	выторговать
прифуговывать	прифуговать
сфуговывать	сфуговать
*	исповедовать
заколдовывать	заколдовать
наколдовывать	наколдовать
приколдовывать	приколдовать
околдовывать	околдовать
расколдовывать	расколдовать
зарекомендовывать	зарекомендовать
отрекомендовывать	отрекомендовать
заарендовывать	заарендовать
приарендовывать	приарендовать
замордовывать	замордовать
*	образовать
образовывать	образовать
*	преобразовать
*	прообразовать
*	сообразовать
*	реализовать
закристаллизовывать	закристаллизовать
выкристаллизовывать	выкристаллизовать
*	организовать
*	реорганизовать
переорганизовывать	переорганизовать
*	дезорганизовать
сорганизовывать	сорганизовать
наэлектризовывать	наэлектризовать
заковывать	заковать
наковывать	наковать
запаковывать	запаковать
перепаковывать	перепаковать
распаковывать	распаковать
упаковывать	упаковать
переупаковывать	переупаковать
забраковывать	забраковать
набраковывать	набраковать
перебраковывать	перебраковать
разбраковывать	разбраковать
отбраковывать	отбраковать
выбраковывать	выбраковать
вковывать	вковать
надковывать	надковать
подковывать	подковать
перековывать	перековать
опубликовывать	опубликовать
распубликовывать	распубликовать
приковывать	приковать
раскритиковывать	раскритиковать
втолковывать	втолковать
перетолковывать	перетолковать
растолковывать	растолковать
истолковывать	истолковать
оцинковывать	оцинковать
нашинковывать	нашинковать
оковывать	оковать
доковывать	доковать
проковывать	проковать
запарковывать	запарковать
припарковывать	припарковать
окирковывать	окирковать
сковывать	сковать
расковывать	расковать
отковывать	отковать
заштуковывать	заштуковать
приштуковывать	приштуковать
выковывать	выковать
пристыковывать	пристыковать
состыковывать	состыковать
отстыковывать	отстыковать
затюковывать	затюковать
растюковывать	растюковать
забаловывать	забаловать
набаловывать	набаловать
разбаловывать	разбаловать
избаловывать	избаловать
зацеловывать	зацеловать
расцеловывать	расцеловать
переформовывать	переформовать
сформовывать	сформовать
отформовывать	отформовать
зарифмовывать	зарифмовать
ошельмовывать	ошельмовать
*	ассигновать
переассигновывать	переассигновать
разассигновывать	разассигновать
переэкзаменовывать	переэкзаменовать
ознаменовывать	ознаменовать
наименовывать	наименовать
переименовывать	переименовать
налиновывать	налиновать
перелиновывать	перелиновать
разлиновывать	разлиновать
замариновывать	замариновать
намариновывать	намариновать
перебороновывать	перебороновать
разбороновывать	разбороновать
основывать	основать
обосновывать	обосновать
проштамповывать	проштамповать
отштамповывать	отштамповать
зачаровывать	зачаровать
очаровывать	очаровать
разочаровывать	разочаровать
заномеровывать	заномеровать
переномеровывать	переномеровать
прономеровывать	прономеровать
занумеровывать	занумеровать
перенумеровывать	перенумеровать
пронумеровывать	пронумеровать
запломбировывать	запломбировать
опломбировывать	опломбировать
прикомандировывать	прикомандировать
откомандировывать	откомандировать
обмундировывать	обмундировать
переобмундировывать	переобмундировать
набронзировывать	набронзировать
залакировывать	залакировать
налакировывать	налакировать
подлакировывать	подлакировать
перелакировывать	перелакировать
отлакировывать	отлакировать
распикировывать	распикировать
замаскировывать	замаскировать
обмеблировывать	обмеблировать
омеблировывать	омеблировать
наполировывать	наполировать
отполировывать	отполировать
загримировывать	загримировать
нагримировывать	нагримировать
подгримировывать	подгримировать
разгримировывать	разгримировать
переформировывать	переформировать
сформировывать	сформировать
расформировывать	расформировать
перепланировывать	перепланировать
перепланировывать	перепланировать
распланировывать	распланировать
задрапировывать	задрапировать
перегруппировывать	перегруппировать
разгруппировывать	разгруппировать
сгруппировывать	сгруппировать
забаллотировывать	забаллотировать
перебаллотировывать	перебаллотировать
расквартировывать	расквартировать
насортировывать	насортировать
пересортировывать	пересортировать
рассортировывать	рассортировать
отсортировывать	отсортировать
наворовывать	наворовать
обворовывать	обворовать
разворовывать	разворовать
уворовывать	уворовать
профильтровывать	профильтровать
отфильтровывать	отфильтровать
замуровывать	замуровать
обмуровывать	обмуровать
вмуровывать	вмуровать
подмуровывать	подмуровать
размуровывать	размуровать
зашнуровывать	зашнуровать
перешнуровывать	перешнуровать
прошнуровывать	прошнуровать
расшнуровывать	расшнуровать
зашифровывать	зашифровать
расшифровывать	расшифровать
засовывать	засовать
согласовывать	согласовать
насовывать	насовать
припасовывать	припасовать
распасовывать	распасовать
отпасовывать	отпасовать
втасовывать	втасовать
подтасовывать	подтасовать
перетасовывать	перетасовать
растасовывать	растасовать
расфасовывать	расфасовать
всовывать	всовать
подсовывать	подсовать
переадресовывать	переадресовать
заинтересовывать	заинтересовать
зарисовывать	зарисовать
обрисовывать	обрисовать
подрисовывать	подрисовать
перерисовывать	перерисовать
разрисовывать	разрисовать
изрисовывать	изрисовать
пририсовывать	пририсовать
дорисовывать	дорисовать
прорисовывать	прорисовать
срисовывать	срисовать
вырисовывать	вырисовать
располосовывать	располосовать
исполосовывать	исполосовать
рассовывать	рассовать
запрессовывать	запрессовать
напрессовывать	напрессовать
впрессовывать	впрессовать
спрессовывать	спрессовать
приплюсовывать	приплюсовать
законтрактовывать	законтрактовать
укомплектовывать	укомплектовать
разукомплектовывать	разукомплектовать
доукомплектовывать	доукомплектовать
надиктовывать	надиктовать
перекантовывать	перекантовать
окантовывать	окантовать
запатентовывать	запатентовать
забинтовывать	забинтовать
перебинтовывать	перебинтовать
разбинтовывать	разбинтовать
прибинтовывать	прибинтовать
зашпунтовывать	зашпунтовать
загрунтовывать	загрунтовать
нагрунтовывать	нагрунтовать
перегрунтовывать	перегрунтовать
уготовлять	уготовать
зашвартовывать	зашвартовать
пришвартовывать	пришвартовать
отшвартовывать	отшвартовать
заспиртовывать	заспиртовать
наспиртовывать	наспиртовать
проспиртовывать	проспиртовать
напластовывать	напластовать
*	арестовать
заарестовывать	заарестовать
опротестовывать	опротестовать
переаттестовывать	переаттестовать
зафрахтовывать	зафрахтовать
расшлихтовывать	расшлихтовать
размачтовывать	размачтовать
зашлифовывать	зашлифовать
перешлифовывать	перешлифовать
пришлифовывать	пришлифовать
ошлифовывать	ошлифовать
отшлифовывать	отшлифовать
вышлифовывать	вышлифовать
застраховывать	застраховать
подстраховывать	подстраховать
перестраховывать	перестраховать
заштриховывать	заштриховать
нарывать	нарвать
нарывать	нарвать
перерывать	перервать
прерывать	прервать
обрывать	оборвать
дорывать	дорвать
надрывать	надорвать
подрывать	подорвать
разрывать	разорвать
взрывать	взорвать
изрывать	изорвать
порывать	порвать
прорывать	прорвать
срывать	сорвать
отрывать	оторвать
урывать	урвать
вырывать	вырвать
дошагивать	дошагать
отшагивать	отшагать
вышагивать	вышагать
оббегать	оббегать
обегать	обегать
застегивать	застегать
настегивать	настегать
подстегивать	подстегать
перестегивать	перестегать
пристегивать	пристегать
достегивать	достегать
простегивать	простегать
состегивать	состегать
расстегивать	расстегать
исстегивать	исстегать
выстегивать	выстегать
замызгивать	замызгать
обмызгивать	обмызгать
измызгивать	измызгать
забрызгивать	забрызгать
набрызгивать	набрызгать
разбрызгивать	разбрызгать
обрызгивать	обрызгать
выбрызгивать	выбрызгать
задрызгивать	задрызгать
надрызгивать	надрызгать
прилыгать	прилгать
застрагивать	застрогать
настрагивать	настрогать
обстрагивать	обстрогать
надстрагивать	надстрогать
подстрагивать	подстрогать
перестрагивать	перестрогать
пристрагивать	пристрогать
острагивать	острогать
прострагивать	прострогать
сострагивать	сострогать
исстрагивать	исстрогать
отстрагивать	отстрогать
устрагивать	устрогать
выстрагивать	выстрогать
задергивать	задергать
надергивать	надергать
обдергивать	обдергать
раздергивать	раздергать
издергивать	издергать
продергивать	продергать
сдергивать	сдергать
выдергивать	выдергать
промаргивать	проморгать
запугивать	запугать
распугивать	распугать
обругивать	обругать
доругивать	доругать
застругивать	застругать
настругивать	настругать
обстругивать	обстругать
надстругивать	надстругать
подстругивать	подстругать
перестругивать	перестругать
пристругивать	пристругать
остругивать	остругать
простругивать	простругать
состругивать	состругать
исстругивать	исстругать
отстругивать	отстругать
устругивать	устругать
выстругивать	выстругать
обшмыгивать	обшмыгать
припрыгивать	припрыгать
допрыгивать	допрыгать
отпрыгивать	отпрыгать
упрыгивать	упрыгать
давать	дать
загадывать	загадать
нагадывать	нагадать
подгадывать	подгадать
перегадывать	перегадать
разгадывать	разгадать
прогадывать	прогадать
отгадывать	отгадать
угадывать	угадать
предугадывать	предугадать
выгадывать	выгадать
задавать	задать
нападать	нападать
обдавать	обдать
оправдывать	оправдать
наддавать	наддать
поддавать	поддать
наподдавать	наподдать
разведывать	разведать
изведывать	изведать
поведывать	поведать
заповедовать	заповедать
проповедовать	проповедать
исповедовать	исповедать
проведывать	проведать
отведывать	отведать
выведывать	выведать
передавать	передать
предавать	предать
пережидать	переждать
выжидать	выждать
загваздывать	загваздать
раздавать	раздать
издавать	издать
переиздавать	переиздать
воздавать	воздать
запаздывать	запоздать
припаздывать	припоздать
опаздывать	опоздать
создавать	создать
пересоздавать	пересоздать
воссоздавать	воссоздать
обуздывать	обуздать
подуздывать	подуздать
зануздывать	зануздать
разнуздывать	разнуздать
взнуздывать	взнуздать
закидывать	закидать
накидывать	накидать
обкидывать	обкидать
вкидывать	вкидать
подкидывать	подкидать
прикидывать	прикидать
докидывать	докидать
прокидывать	прокидать
скидывать	скидать
раскидывать	раскидать
откидывать	откидать
выкидывать	выкидать
придавать	придать
додавать	додать
недодавать	недодать
обгладывать	обглодать
подгладывать	подглодать
изгладывать	изглодать
огладывать	оглодать
догладывать	доглодать
прогладывать	проглодать
сгладывать	сглодать
отгладывать	отглодать
выгладывать	выглодать
подавать	подать
преподавать	преподать
продавать	продать
запродавать	запродать
перепродавать	перепродать
допродавать	допродать
распродавать	распродать
сдавать	сдать
пересдавать	пересдать
отдавать	отдать
выдавать	выдать
зажимать	зажать
зажинать	зажать
нажимать	нажать
нажинать	нажать
поднажимать	поднажать
насаживать	насажать
досаживать	досажать
усаживать	усажать
обжимать	обжать
обжинать	обжать
вжимать	вжать
поджимать	поджать
поджинать	поджать
забегать	забежать
набегать	набежать
оббегать	оббежать
вбегать	вбежать
подбегать	подбежать
перебегать	перебежать
взбегать	взбежать
избегать	избежать
прибегать	прибежать
обегать	обежать
добегать	добежать
пробегать	пробежать
сбегать	сбежать
отбегать	отбежать
убегать	убежать
выбегать	выбежать
належивать	належать
облеживать	облежать
перележивать	перележать
долеживать	долежать
пролеживать	пролежать
отлеживать	отлежать
вылеживать	вылежать
пережимать	пережать
пережинать	пережать
заважживать	завожжать
разважживать	развожжать
разжимать	разжать
прижимать	прижать
дожимать	дожать
дожинать	дожать
недожимать	недожать
недожинать	недожать
пожимать	пожать
пожинать	пожать
прожимать	прожать
прожинать	прожать
задерживать	задержать
поддерживать	поддержать
передерживать	передержать
издерживать	издержать
воздерживать	воздержать
придерживать	придержать
одерживать	одержать
додерживать	додержать
недодерживать	недодержать
сдерживать	сдержать
удерживать	удержать
приудерживать	приудержать
выдерживать	выдержать
сжимать	сжать
сжинать	сжать
отжимать	отжать
отжинать	отжать
ужимать	ужать
ужинать	ужать
выжимать	выжать
выжинать	выжать
заказывать	заказать
наказывать	наказать
приказывать	приказать
оказывать	оказать
доказывать	доказать
показывать	показать
насказывать	насказать
обсказывать	обсказать
предсказывать	предсказать
подсказывать	подсказать
пересказывать	пересказать
досказывать	досказать
недосказывать	недосказать
рассказывать	рассказать
высказывать	высказать
отказывать	отказать
отказывать	отказать
указывать	указать
выказывать	выказать
замазывать	замазать
намазывать	намазать
обмазывать	обмазать
вмазывать	вмазать
подмазывать	подмазать
перемазывать	перемазать
размазывать	размазать
измазывать	измазать
примазывать	примазать
домазывать	домазать
помазывать	помазать
миропомазывать	миропомазать
промазывать	промазать
смазывать	смазать
отмазывать	отмазать
умазывать	умазать
вымазывать	вымазать
нарезать	нарезать
обрезать	обрезать
обрезать	обрезать
врезать	врезать
надрезать	надрезать
подрезать	подрезать
перерезать	перерезать
разрезать	разрезать
взрезать	взрезать
изрезать	изрезать
прирезать	прирезать
дорезать	дорезать
прорезать	прорезать
срезать	срезать
отрезать	отрезать
отрезать	отрезать
урезать	урезать
вырезать	вырезать
вырезать	вырезать
зализывать	зализать
облизывать	облизать
подлизывать	подлизать
разлизывать	разлизать
излизывать	излизать
прилизывать	прилизать
долизывать	долизать
пролизывать	пролизать
слизывать	слизать
отлизывать	отлизать
вылизывать	вылизать
нанизывать	нанизать
обнизывать	обнизать
поднизывать	поднизать
перенизывать	перенизать
разнизывать	разнизать
изнизывать	изнизать
принизывать	принизать
донизывать	донизать
пронизывать	пронизать
снизывать	снизать
отнизывать	отнизать
унизывать	унизать
вынизывать	вынизать
растерзывать	растерзать
обязывать	обязать
завязывать	завязать
навязывать	навязать
обвязывать	обвязать
ввязывать	ввязать
надвязывать	надвязать
подвязывать	подвязать
перевязывать	перевязать
развязывать	развязать
извязывать	извязать
привязывать	привязать
довязывать	довязать
повязывать	повязать
провязывать	провязать
связывать	связать
отвязывать	отвязать
увязывать	увязать
вывязывать	вывязать
заскакивать	заскакать
наскакивать	наскакать
обскакивать	обскакать
вскакивать	вскакать
подскакивать	подскакать
перескакивать	перескакать
прискакивать	прискакать
доскакивать	доскакать
проскакивать	проскакать
отскакивать	отскакать
ускакивать	ускакать
выскакивать	выскакать
оплакивать	оплакать
выплакивать	выплакать
закликать	закликать
накликать	накликать
скликать	скликать
общелкивать	общелкать
расщелкивать	расщелкать
отщелкивать	отщелкать
выщелкивать	выщелкать
заталкивать	затолкать
наталкивать	натолкать
вталкивать	втолкать
приталкивать	притолкать
проталкивать	протолкать
расталкивать	растолкать
отталкивать	оттолкать
выталкивать	вытолкать
скомкивать	скомкать
захаркивать	захаркать
обхаркивать	обхаркать
отхаркивать	отхаркать
выхаркивать	выхаркать
зашаркивать	зашаркать
обшаркивать	обшаркать
исшаркивать	исшаркать
вышаркивать	вышаркать
перековеркивать	перековеркать
исковеркивать	исковеркать
зачеркивать	зачеркать
зачеркивать	зачеркать
перечеркивать	перечеркать
перечеркивать	перечеркать
исчеркивать	исчеркать
исчеркивать	исчеркать
вычеркивать	вычеркать
исчиркивать	исчиркать
засмаркивать	засморкать
обласкивать	обласкать
затаскивать	затаскать
натаскивать	натаскать
втаскивать	втаскать
подтаскивать	подтаскать
дотаскивать	дотаскать
стаскивать	стаскать
растаскивать	растаскать
истаскивать	истаскать
оттаскивать	оттаскать
вытаскивать	вытаскать
заплескивать	заплескать
наплескивать	наплескать
оплескивать	оплескать
расплескивать	расплескать
отплескивать	отплескать
выплескивать	выплескать
приискивать	приискать
снискивать	снискать
затискивать	затискать
натискивать	натискать
обтискивать	обтискать
втискивать	втискать
подтискивать	подтискать
протискивать	протискать
растискивать	растискать
истискивать	истискать
оттискивать	оттискать
утискивать	утискать
выискивать	выискать
заполаскивать	заполоскать
наполаскивать	наполоскать
переполаскивать	переполоскать
ополаскивать	ополоскать
дополаскивать	дополоскать
прополаскивать	прополоскать
отполаскивать	отполоскать
выполаскивать	выполоскать
обыскивать	обыскать
подыскивать	подыскать
разыскивать	разыскать
взыскивать	взыскать
довзыскивать	довзыскать
изыскивать	изыскать
запрыскивать	запрыскать
напрыскивать	напрыскать
опрыскивать	опрыскать
распрыскивать	распрыскать
испрыскивать	испрыскать
выпрыскивать	выпрыскать
сыскивать	сыскать
отыскивать	отыскать
отпрукивать	отпрукать
застукивать	застукать
настукивать	настукать
обстукивать	обстукать
перестукивать	перестукать
пристукивать	пристукать
простукивать	простукать
отстукивать	отстукать
выстукивать	выстукать
размыкивать	размыкать
натыкать	натыкать
обтыкать	обтыкать
подтыкать	подтыкать
протыкать	протыкать
растыкать	растыкать
истыкивать	истыкать
утыкать	утыкать
науськивать	науськать
подуськивать	подуськать
забаюкивать	забаюкать
убаюкивать	убаюкать
заседлывать	заседлать
подседлывать	подседлать
переседлывать	переседлать
оседлывать	оседлать
расседлывать	расседлать
заделывать	заделать
обделывать	обделать
вделывать	вделать
подделывать	подделать
переделывать	переделать
разделывать	разделать
возделывать	возделать
приделывать	приделать
доделывать	доделать
недоделывать	недоделать
проделывать	проделать
отделывать	отделать
уделывать	уделать
выделывать	выделать
засылать	заслать
насылать	наслать
пересылать	переслать
присылать	прислать
досылать	дослать
подсылать	подослать
рассылать	разослать
посылать	послать
предпосылать	предпослать
ниспосылать	ниспослать
ссылать	сослать
отсылать	отослать
усылать	услать
высылать	выслать
застилать	застлать
настилать	настлать
перестилать	перестлать
достилать	достлать
подстилать	подостлать
расстилать	разостлать
исстилать	изостлать
постилать	постлать
простилать	простлать
устилать	устлать
выстилать	выстлать
наламывать	наломать
обламывать	обломать
надламывать	надломать
подламывать	подломать
разламывать	разломать
взламывать	взломать
изламывать	изломать
доламывать	доломать
проламывать	проломать
отламывать	отломать
уламывать	уломать
выламывать	выломать
задумывать	задумать
надумывать	надумать
обдумывать	обдумать
передумывать	передумать
раздумывать	раздумать
придумывать	придумать
додумывать	додумать
недодумывать	недодумать
продумывать	продумать
отдумывать	отдумать
удумывать	удумать
выдумывать	выдумать
загонять	загнать
нагонять	нагнать
перегонять	перегнать
изгонять	изгнать
возгонять	возгнать
пригонять	пригнать
обгонять	обогнать
вгонять	вогнать
догонять	догнать
подгонять	подогнать
разгонять	разогнать
прогонять	прогнать
сгонять	согнать
отгонять	отогнать
угонять	угнать
выгонять	выгнать
запеленывать	запеленать
перепеленывать	перепеленать
распеленывать	распеленать
упеленывать	упеленать
признавать	признать
познавать	познать
опознавать	опознать
распознавать	распознать
прознавать	прознать
сознавать	сознать
осознавать	осознать
узнавать	узнать
предузнавать	предузнать
разузнавать	разузнать
вызнавать	вызнать
доканывать	доконать
закапывать	закапать
накапывать	накапать
обкапывать	обкапать
вкапывать	вкапать
подкапывать	подкапать
перекапывать	перекапать
окапывать	окапать
докапывать	докапать
прокапывать	прокапать
скапывать	скапать
искапывать	искапать
откапывать	откапать
укапывать	укапать
залапывать	залапать
нацарапывать	нацарапать
обцарапывать	обцарапать
оцарапывать	оцарапать
процарапывать	процарапать
сцарапывать	сцарапать
расцарапывать	расцарапать
исцарапывать	исцарапать
выцарапывать	выцарапать
закрапывать	закрапать
накрапывать	накрапать
захапывать	захапать
нахапывать	нахапать
зацапывать	зацапать
подцапывать	подцапать
сцапывать	сцапать
заклепывать	заклепать
наклепывать	наклепать
вклепывать	вклепать
надклепывать	надклепать
подклепывать	подклепать
переклепывать	переклепать
приклепывать	приклепать
проклепывать	проклепать
склепывать	склепать
расклепывать	расклепать
отклепывать	отклепать
выклепывать	выклепать
нашлепывать	нашлепать
обшлепывать	обшлепать
отшлепывать	отшлепать
затрепывать	затрепать
обтрепывать	обтрепать
растрепывать	растрепать
встрепывать	встрепать
истрепывать	истрепать
оттрепывать	оттрепать
вытрепывать	вытрепать
нащипывать	нащипать
общипывать	общипать
подщипывать	подщипать
перещипывать	перещипать
ощипывать	ощипать
дощипывать	дощипать
сощипывать	сощипать
расщипывать	расщипать
исщипывать	исщипать
отщипывать	отщипать
выщипывать	выщипать
закапывать	закопать
накапывать	накопать
обкапывать	обкопать
вкапывать	вкопать
подкапывать	подкопать
перекапывать	перекопать
прикапывать	прикопать
окапывать	окопать
докапывать	докопать
прокапывать	прокопать
скапывать	скопать
раскапывать	раскопать
вскапывать	вскопать
искапывать	ископать
откапывать	откопать
выкапывать	выкопать
нахлопывать	нахлопать
обхлопывать	обхлопать
перехлопывать	перехлопать
охлопывать	охлопать
прохлопывать	прохлопать
отхлопывать	отхлопать
ухлопывать	ухлопать
оттопывать	оттопать
утопывать	утопать
заштопывать	заштопать
обштопывать	обштопать
подштопывать	подштопать
перештопывать	перештопать
проштопывать	проштопать
исштопывать	исштопать
уштопывать	уштопать
обшарпывать	обшарпать
начерпывать	начерпать
дочерпывать	дочерпать
счерпывать	счерпать
исчерпывать	исчерпать
отчерпывать	отчерпать
вычерпывать	вычерпать
засыпать	заспать
пересыпать	переспать
досыпать	доспать
недосыпать	недоспать
просыпать	проспать
наколупывать	наколупать
проколупывать	проколупать
сколупывать	сколупать
расколупывать	расколупать
исколупывать	исколупать
отколупывать	отколупать
выколупывать	выколупать
нащупывать	нащупать
ощупывать	ощупать
прощупывать	прощупать
ущупывать	ущупать
выщупывать	выщупать
засыпать	засыпать
насыпать	насыпать
обсыпать	обсыпать
всыпать	всыпать
надсыпать	надсыпать
подсыпать	подсыпать
пересыпать	пересыпать
присыпать	присыпать
осыпать	осыпать
досыпать	досыпать
недосыпать	недосыпать
посыпать	посыпать
просыпать	просыпать
ссыпать	ссыпать
рассыпать	рассыпать
отсыпать	отсыпать
усыпать	усыпать
высыпать	высыпать
заляпывать	заляпать
наляпывать	наляпать
обляпывать	обляпать
вляпывать	вляпать
разляпывать	разляпать
приляпывать	приляпать
отляпывать	отляпать
настряпывать	настряпать
обстряпывать	обстряпать
достряпывать	достряпать
обтяпывать	обтяпать
подтяпывать	подтяпать
растяпывать	растяпать
оттяпывать	оттяпать
замарывать	замарать
обмарывать	обмарать
перемарывать	перемарать
измарывать	измарать
смарывать	смарать
вымарывать	вымарать
забирать	забрать
набирать	набрать
перебирать	перебрать
избирать	избрать
переизбирать	переизбрать
доизбирать	доизбрать
прибирать	прибрать
обирать	обобрать
вбирать	вобрать
добирать	добрать
недобирать	недобрать
подбирать	подобрать
разбирать	разобрать
пробирать	пробрать
собирать	собрать
отбирать	отобрать
убирать	убрать
разубирать	разубрать
выбирать	выбрать
перевыбирать	перевыбрать
перевирать	переврать
привирать	приврать
подвирать	подоврать
заигрывать	заиграть
наигрывать	наиграть
переигрывать	переиграть
доигрывать	доиграть
недоигрывать	недоиграть
проигрывать	проиграть
выигрывать	выиграть
обыгрывать	обыграть
подыгрывать	подыграть
разыгрывать	разыграть
отыгрывать	отыграть
задирать	задрать
надирать	надрать
передирать	передрать
обдирать	ободрать
додирать	додрать
наддирать	надодрать
поддирать	пододрать
раздирать	разодрать
издирать	изодрать
продирать	продрать
сдирать	содрать
отдирать	отодрать
удирать	удрать
выдирать	выдрать
нажирать	нажрать
пережирать	пережрать
обжирать	обожрать
дожирать	дожрать
пожирать	пожрать
пожирать	пожрать
прожирать	прожрать
сжирать	сожрать
выжирать	выжрать
застирывать	застирать
настирывать	настирать
обстирывать	обстирать
перестирывать	перестирать
достирывать	достирать
простирывать	простирать
состирывать	состирать
исстирывать	исстирать
отстирывать	отстирать
выстирывать	выстирать
попирать	попрать
затесывать	затесать
натесывать	натесать
обтесывать	обтесать
надтесывать	надтесать
подтесывать	подтесать
перетесывать	перетесать
притесывать	притесать
отесывать	отесать
протесывать	протесать
стесывать	стесать
растесывать	растесать
истесывать	истесать
оттесывать	оттесать
утесывать	утесать
вытесывать	вытесать
зачесывать	зачесать
начесывать	начесать
обчесывать	обчесать
подчесывать	подчесать
перечесывать	перечесать
причесывать	причесать
очесывать	очесать
дочесывать	дочесать
прочесывать	прочесать
счесывать	счесать
расчесывать	расчесать
отчесывать	отчесать
учесывать	учесать
вычесывать	вычесать
записывать	записать
перезаписывать	перезаписать
вписывать	вписать
надписывать	надписать
предписывать	предписать
подписывать	подписать
переписывать	переписать
приписывать	приписать
описывать	описать
дописывать	дописать
недописывать	недописать
прописывать	прописать
списывать	списать
расписывать	расписать
исписывать	исписать
отписывать	отписать
уписывать	уписать
выписывать	выписать
забрасывать	забросать
набрасывать	набросать
вбрасывать	вбросать
подбрасывать	подбросать
разбрасывать	разбросать
прибрасывать	прибросать
добрасывать	добросать
пробрасывать	пробросать
сбрасывать	сбросать
отбрасывать	отбросать
выбрасывать	выбросать
засасывать	засосать
насасывать	насосать
обсасывать	обсосать
всасывать	всосать
подсасывать	подсосать
пересасывать	пересосать
присасывать	присосать
досасывать	дососать
просасывать	прососать
ссасывать	ссосать
рассасывать	рассосать
иссасывать	иссосать
отсасывать	отсосать
высасывать	высосать
накусывать	накусать
обкусывать	обкусать
надкусывать	надкусать
искусывать	искусать
откусывать	откусать
выкусывать	выкусать
наплясывать	наплясать
доплясывать	доплясать
отплясывать	отплясать
выплясывать	выплясать
подпоясывать	подпоясать
перепоясывать	перепоясать
препоясывать	препоясать
опоясывать	опоясать
распоясывать	распоясать
засватывать	засватать
присватывать	присватать
просватывать	просватать
сосватывать	сосватать
высватывать	высватать
захватывать	захватать
нахватывать	нахватать
обхватывать	обхватать
расхватывать	расхватать
отхватывать	отхватать
закатывать	закатать
накатывать	накатать
обкатывать	обкатать
вкатывать	вкатать
подкатывать	подкатать
перекатывать	перекатать
прикатывать	прикатать
докатывать	докатать
прокатывать	прокатать
скатывать	скатать
раскатывать	раскатать
откатывать	откатать
укатывать	укатать
выкатывать	выкатать
подлатывать	подлатать
запечатывать	запечатать
впечатывать	впечатать
подпечатывать	подпечатать
перепечатывать	перепечатать
припечатывать	припечатать
опечатывать	опечатать
допечатывать	допечатать
пропечатывать	пропечатать
спечатывать	спечатать
распечатывать	распечатать
отпечатывать	отпечатать
упечатывать	упечатать
расшатывать	расшатать
облетывать	облетать
заметывать	заметать
заметывать	заметать
наметывать	наметать
наметывать	наметать
обметывать	обметать
обметывать	обметать
вметывать	вметать
подметывать	подметать
переметывать	переметать
переметывать	переметать
разметывать	разметать
взметывать	взметать
приметывать	приметать
приметывать	приметать
дометывать	дометать
дометывать	дометать
прометывать	прометать
сметывать	сметать
сметывать	сметать
уметывать	уметать
выметывать	выметать
выметывать	выметать
сквитывать	сквитать
отквитывать	отквитать
напитывать	напитать
впитывать	впитать
пропитывать	пропитать
воспитывать	воспитать
перевоспитывать	перевоспитать
упитывать	упитать
зачитывать	зачитать
начитывать	начитать
подчитывать	подчитать
перечитывать	перечитать
дочитывать	дочитать
прочитывать	прочитать
считывать	считать
засчитывать	засчитать
насчитывать	насчитать
обсчитывать	обсчитать
подсчитывать	подсчитать
пересчитывать	пересчитать
присчитывать	присчитать
досчитывать	досчитать
недосчитывать	недосчитать
просчитывать	просчитать
сосчитывать	сосчитать
рассчитывать	рассчитать
рассчитывать	рассчитать
отсчитывать	отсчитать
усчитывать	усчитать
высчитывать	высчитать
отчитывать	отчитать
вычитывать	вычитать
забалтывать	заболтать
набалтывать	наболтать
подбалтывать	подболтать
перебалтывать	переболтать
разбалтывать	разболтать
взбалтывать	взболтать
пробалтывать	проболтать
сбалтывать	сболтать
выбалтывать	выболтать
зарабатывать	заработать
подзарабатывать	подзаработать
нарабатывать	наработать
обрабатывать	обработать
подрабатывать	подработать
перерабатывать	переработать
разрабатывать	разработать
прирабатывать	приработать
дорабатывать	доработать
недорабатывать	недоработать
прорабатывать	проработать
срабатывать	сработать
отрабатывать	отработать
вырабатывать	выработать
недовырабатывать	недовыработать
заглатывать	заглотать
заматывать	замотать
наматывать	намотать
обматывать	обмотать
вматывать	вмотать
подматывать	подмотать
перематывать	перемотать
разматывать	размотать
изматывать	измотать
приматывать	примотать
доматывать	домотать
проматывать	промотать
сматывать	смотать
отматывать	отмотать
уматывать	умотать
выматывать	вымотать
исхлопатывать	исхлопотать
отхлопатывать	отхлопотать
выхлопатывать	выхлопотать
нашептывать	нашептать
затаптывать	затоптать
натаптывать	натоптать
обтаптывать	обтоптать
втаптывать	втоптать
подтаптывать	подтоптать
перетаптывать	перетоптать
притаптывать	притоптать
отаптывать	отоптать
протаптывать	протоптать
стаптывать	стоптать
растаптывать	растоптать
истаптывать	истоптать
оттаптывать	оттоптать
утаптывать	утоптать
вытаптывать	вытоптать
становиться	стать
заграбастывать	заграбастать
заставать	застать
перепластывать	перепластать
распластывать	распластать
упластывать	упластать
наставать	настать
обставать	обстать
вставать	встать
привставать	привстать
представать	предстать
захлестывать	захлестать
нахлестывать	нахлестать
обхлестывать	обхлестать
схлестывать	схлестать
расхлестывать	расхлестать
исхлестывать	исхлестать
отхлестывать	отхлестать
ухлестывать	ухлестать
выхлестывать	выхлестать
переставать	перестать
преставать	престать
насвистывать	насвистать
пересвистывать	пересвистать
освистывать	освистать
просвистывать	просвистать
высвистывать	высвистать
перелистывать	перелистать
пролистывать	пролистать
приставать	пристать
доставать	достать
недоставать	недостать
опрастывать	опростать
выпрастывать	выпростать
заверстывать	заверстать
наверстывать	наверстать
вверстывать	вверстать
подверстывать	подверстать
переверстывать	переверстать
разверстывать	разверстать
приверстывать	приверстать
сверстывать	сверстать
уверстывать	уверстать
восставать	восстать
отставать	отстать
приотставать	приотстать
уставать	устать
приуставать	приустать
отхлыстывать	отхлыстать
закутывать	закутать
накутывать	накутать
перекутывать	перекутать
окутывать	окутать
раскутывать	раскутать
укутывать	укутать
запутывать	запутать
напутывать	напутать
впутывать	впутать
подпутывать	подпутать
перепутывать	перепутать
припутывать	припутать
опутывать	опутать
спутывать	спутать
распутывать	распутать
отпутывать	отпутать
упутывать	упутать
выпутывать	выпутать
допытывать	допытать
распытывать	распытать
испытывать	испытать
выпытывать	выпытать
запрятывать	запрятать
подпрятывать	подпрятать
перепрятывать	перепрятать
припрятывать	припрятать
упрятывать	упрятать
обмахивать	обмахать
размахивать	размахать
отмахивать	отмахать
отмахивать	отмахать
вымахивать	вымахать
запахивать	запахать
напахивать	напахать
подпахивать	подпахать
перепахивать	перепахать
припахивать	припахать
опахивать	опахать
допахивать	допахать
пропахивать	пропахать
спахивать	спахать
распахивать	распахать
вспахивать	вспахать
испахивать	испахать
выпахивать	выпахать
заезжать	заехать
наезжать	наехать
переезжать	переехать
приезжать	приехать
доезжать	доехать
проезжать	проехать
уезжать	уехать
объезжать	объехать
въезжать	въехать
подъезжать	подъехать
взъезжать	взъехать
съезжать	съехать
отъезжать	отъехать
выезжать	выехать
запихивать	запихать
напихивать	напихать
впихивать	впихать
подпихивать	подпихать
пропихивать	пропихать
распихивать	распихать
упихивать	упихать
выпихивать	выпихать
вычихивать	вычихать
вбухивать	вбухать
выбухивать	выбухать
расколыхивать	расколыхать
всколыхивать	всколыхать
нанюхивать	нанюхать
обнюхивать	обнюхать
разнюхивать	разнюхать
пронюхивать	пронюхать
вынюхивать	вынюхать
зачинать	зачать
закачивать	закачать
накачивать	накачать
вкачивать	вкачать
подкачивать	подкачать
перекачивать	перекачать
прикачивать	прикачать
прокачивать	прокачать
скачивать	скачать
раскачивать	раскачать
откачивать	откачать
укачивать	укачать
выкачивать	выкачать
начинать	начать
затачивать	затачать
натачивать	натачать
обтачивать	обтачать
втачивать	втачать
подтачивать	подтачать
перетачивать	перетачать
притачивать	притачать
дотачивать	дотачать
протачивать	протачать
стачивать	стачать
растачивать	растачать
утачивать	утачать
перекрикивать	перекричать
замалчивать	замолчать
умалчивать	умолчать
развенчивать	развенчать
увенчивать	увенчать
починать	почать
обстукивать	обстучать
простукивать	простучать
отстукивать	отстучать
завешивать	завешать
навешивать	навешать
обвешивать	обвешать
перевешивать	перевешать
развешивать	развешать
довешивать	довешать
увешивать	увешать
замешивать	замешать
намешивать	намешать
вмешивать	вмешать
подмешивать	подмешать
перемешивать	перемешать
размешивать	размешать
примешивать	примешать
домешивать	домешать
промешивать	промешать
смешивать	смешать
умешивать	умешать
вымешивать	вымешать
заслушивать	заслушать
подслушивать	подслушать
дослушивать	дослушать
недослушивать	недослушать
прослушивать	прослушать
выслушивать	выслушать
застращивать	застращать
настращивать	настращать
пристращивать	пристращать
ослабевать	ослабеть
расслабевать	расслабеть
огрубевать	огрубеть
выздоравливать	выздороветь
девать	деть
задевать	задеть
завладевать	завладеть
овладевать	овладеть
охладевать	охладеть
надевать	надеть
вдевать	вдеть
поддевать	поддеть
раздевать	раздеть
вздевать	вздеть
воздевать	воздеть
обижать	обидеть
разобижать	разобидеть
засиживать	засидеть
насиживать	насидеть
обсиживать	обсидеть
подсиживать	подсидеть
пересиживать	пересидеть
досиживать	досидеть
просиживать	просидеть
отсиживать	отсидеть
усиживать	усидеть
высиживать	высидеть
обалдевать	обалдеть
одевать	одеть
переодевать	переодеть
разодевать	разодеть
продевать	продеть
затвердевать	затвердеть
отвердевать	отвердеть
оскудевать	оскудеть
обглядывать	обглядеть
подглядывать	подглядеть
приглядывать	приглядеть
оглядывать	оглядеть
доглядывать	доглядеть
недоглядывать	недоглядеть
проглядывать	проглядеть
выглядывать	выглядеть
ошалевать	ошалеть
обомлевать	обомлеть
разомлевать	разомлеть
заболевать	заболеть
одолевать	одолеть
преодолевать	преодолеть
околевать	околеть
запечатлевать	запечатлеть
напечатлевать	напечатлеть
отпечатлевать	отпечатлеть
перетлевать	перетлеть
дотлевать	дотлеть
истлевать	истлеть
онемевать	онеметь
уразумевать	уразуметь
обледеневать	обледенеть
оледеневать	оледенеть
окаменевать	окаменеть
закостеневать	закостенеть
окостеневать	окостенеть
окоченевать	окоченеть
прояснивать	прояснеть
разъяснивать	разъяснеть
выяснивать	выяснеть
запевать	запеть
напевать	напеть
подпевать	подпеть
перепевать	перепеть
закипать	закипеть
накипать	накипеть
перекипать	перекипеть
прикипать	прикипеть
докипать	докипеть
прокипать	прокипеть
вскипать	вскипеть
откипать	откипеть
укипать	укипеть
выкипать	выкипеть
допевать	допеть
претерпевать	претерпеть
распевать	распеть
переспевать	переспеть
приспевать	приспеть
воспевать	воспеть
доспевать	доспеть
подоспевать	подоспеть
поспевать	поспеть
успевать	успеть
преуспевать	преуспеть
выспевать	выспеть
отпевать	отпеть
отупевать	отупеть
выпевать	выпеть
застаревать	застареть
устаревать	устареть
нагревать	нагреть
перегревать	перегреть
взгревать	взгреть
пригревать	пригреть
огревать	огреть
обогревать	обогреть
догревать	догреть
подогревать	подогреть
разогревать	разогреть
прогревать	прогреть
согревать	согреть
отогревать	отогреть
угревать	угреть
замирать	замереть
обмирать	обмереть
помирать	помереть
отмирать	отмереть
умирать	умереть
вымирать	вымереть
запирать	запереть
напирать	напереть
поднапирать	поднапереть
впирать	впереть
подпирать	подпереть
перепирать	перепереть
припирать	припереть
опирать	опереть
пропирать	пропереть
спирать	спереть
распирать	распереть
отпирать	отпереть
упирать	упереть
выпирать	выпереть
затирать	затереть
натирать	натереть
обтирать	обтереть
втирать	втереть
подтирать	подтереть
перетирать	перетереть
притирать	притереть
отирать	отереть
дотирать	дотереть
протирать	протереть
стирать	стереть
растирать	растереть
истирать	истереть
простирать	простереть
распростирать	распростереть
оттирать	оттереть
утирать	утереть
вытирать	вытереть
назревать	назреть
перезревать	перезреть
презирать	презреть
взирать	воззреть
призирать	призреть
обозревать	обозреть
дозревать	дозреть
прозревать	прозреть
созревать	созреть
вызревать	вызреть
загорать	загореть
нагорать	нагореть
обгорать	обгореть
подгорать	подгореть
перегорать	перегореть
изгорать	изгореть
возгорать	возгореть
пригорать	пригореть
догорать	догореть
погорать	погореть
прогорать	прогореть
сгорать	сгореть
отгорать	отгореть
угорать	угореть
выгорать	выгореть
запревать	запреть
напревать	напреть
перепревать	перепреть
опревать	опреть
допревать	допреть
подпревать	подопреть
разопревать	разопреть
пропревать	пропреть
сопревать	сопреть
отпревать	отопреть
упревать	упреть
выпревать	выпреть
насматривать	насмотреть
обсматривать	обсмотреть
подсматривать	подсмотреть
пересматривать	пересмотреть
присматривать	присмотреть
осматривать	осмотреть
досматривать	досмотреть
недосматривать	недосмотреть
просматривать	просмотреть
рассматривать	рассмотреть
усматривать	усмотреть
предусматривать	предусмотреть
высматривать	высмотреть
одуревать	одуреть
отсыревать	отсыреть
залетать	залететь
налетать	налететь
облетать	облететь
влетать	влететь
подлетать	подлететь
перелетать	перелететь
взлетать	взлететь
излетать	излететь
прилетать	прилететь
долетать	долететь
пролетать	пролететь
слетать	слететь
отлетать	отлететь
улетать	улететь
вылетать	вылететь
запотевать	запотеть
пропотевать	пропотеть
отпотевать	отпотеть
выпотевать	выпотеть
наверчивать	навертеть
обверчивать	обвертеть
вверчивать	ввертеть
подверчивать	подвертеть
переверчивать	перевертеть
разверчивать	развертеть
приверчивать	привертеть
доверчивать	довертеть
проверчивать	провертеть
сверчивать	свертеть
отверчивать	отвертеть
выверчивать	вывертеть
насвистывать	насвистеть
просвистывать	просвистеть
просвистывать	просвистеть
высвистывать	высвистеть
залезать	залезть
налезать	налезть
облезать	облезть
облезать	облезть
влезать	влезть
подлезать	подлезть
перелезать	перелезть
взлезать	взлезть
прилезать	прилезть
долезать	долезть
пролезать	пролезть
слезать	слезть
отлезать	отлезть
улезать	улезть
вылезать	вылезть
отверзать	отверзть
загрызать	загрызть
нагрызать	нагрызть
обгрызать	обгрызть
надгрызать	надгрызть
подгрызать	подгрызть
перегрызать	перегрызть
разгрызать	разгрызть
изгрызать	изгрызть
огрызать	огрызть
догрызать	догрызть
прогрызать	прогрызть
сгрызать	сгрызть
отгрызать	отгрызть
угрызать	угрызть
выгрызать	выгрызть
задраивать	задраить
надраивать	надраить
продраивать	продраить
отдраивать	отдраить
выдраивать	выдраить
затаивать	затаить
утаивать	утаить
забивать	забить
ослаблять	ослабить
расслаблять	расслабить
набивать	набить
оббивать	оббить
вбивать	вбить
надбивать	надбить
подбивать	подбить
перебивать	перебить
потреблять	потребить
употреблять	употребить
злоупотреблять	злоупотребить
истреблять	истребить
разбивать	разбить
взбивать	взбить
избивать	избить
прибивать	прибить
зашибать	зашибить
обшибать	обшибить
вшибать	вшибить
подшибать	подшибить
перешибать	перешибить
пришибать	пришибить
дошибать	дошибить
прошибать	прошибить
сшибать	сшибить
расшибать	расшибить
отшибать	отшибить
ушибать	ушибить
вышибать	вышибить
задалбливать	задолбить
надалбливать	надолбить
вдалбливать	вдолбить
наддалбливать	наддолбить
поддалбливать	поддолбить
раздалбливать	раздолбить
издалбливать	издолбить
продалбливать	продолбить
выдалбливать	выдолбить
обивать	обить
добивать	добить
сподоблять	сподобить
уподоблять	уподобить
разжалобливать	разжалобить
озлоблять	озлобить
побивать	побить
раздроблять	раздробить
пробивать	пробить
подсоблять	подсобить
обособлять	обособить
пособлять	пособить
приспосабливать	приспособить
ущерблять	ущербить
выщерблять	выщербить
оскорблять	оскорбить
сбивать	сбить
отбивать	отбить
убивать	убить
пригубливать	пригубить
усугублять	усугубить
усугублять	усугубить
заглублять	заглубить
углублять	углубить
приголубливать	приголубить
зарубать	зарубить
нарубать	нарубить
обрубать	обрубить
врубать	врубить
огрублять	огрубить
надрубать	надрубить
подрубать	подрубить
перерубать	перерубить
разрубать	разрубить
изрубать	изрубить
прирубать	прирубить
дорубать	дорубить
прорубать	прорубить
срубать	срубить
отрубать	отрубить
вырубать	вырубить
выбивать	выбить
вздыбливать	вздыбить
зарыблять	зарыбить
влюблять	влюбить
разлюблять	разлюбить
набавлять	набавить
надбавлять	надбавить
подбавлять	подбавить
разбавлять	разбавить
избавлять	избавить
прибавлять	прибавить
добавлять	добавить
сбавлять	сбавить
отбавлять	отбавить
убавлять	убавить
окровавливать	окровавить
задавливать	задавить
надавливать	надавить
вдавливать	вдавить
поддавливать	поддавить
раздавливать	раздавить
придавливать	придавить
подавлять	подавить
продавливать	продавить
сдавливать	сдавить
отдавливать	отдавить
удавливать	удавить
выдавливать	выдавить
завивать	завить
подзавивать	подзавить
озаглавливать	озаглавить
обезглавливать	обезглавить
возглавлять	возглавить
наплавлять	наплавить
вплавлять	вплавить
переплавлять	переплавить
оплавлять	оплавить
проплавливать	проплавить
сплавлять	сплавить
расплавлять	расплавить
выплавлять	выплавить
ославлять	ославить
прославлять	прославить
расславлять	расславить
обесславливать	обесславить
восславлять	восславить
навивать	навить
поздравлять	поздравить
заправлять	заправить
дозаправлять	дозаправить
направлять	направить
вправлять	вправить
подправлять	подправить
переправлять	переправить
приправлять	приправить
оправлять	оправить
поправлять	поправить
справлять	справить
расправлять	расправить
исправлять	исправить
отправлять	отправить
выправлять	выправить
затравливать	затравить
натравливать	натравить
втравливать	втравить
подтравливать	подтравить
перетравливать	перетравить
притравливать	притравить
отравлять	отравить
протравливать	протравить
стравливать	стравить
растравливать	растравить
вытравливать	вытравить
разбуравливать	разбуравить
пробуравливать	пробуравить
выбуравливать	выбуравить
перемуравливать	перемуравить
заставлять	заставить
наставлять	наставить
обставлять	обставить
вставлять	вставить
надставлять	надставить
представлять	представить
подставлять	подставить
переставлять	переставить
приставлять	приставить
оставлять	оставить
доставлять	доставить
предоставлять	предоставить
поставлять	поставить
противопоставлять	противопоставить
сопоставлять	сопоставить
проставлять	проставить
составлять	составить
пересоставлять	пересоставить
расставлять	расставить
восставлять	восставить
отставлять	отставить
уставлять	уставить
выставлять	выставить
обвивать	обвить
ввивать	ввить
надвивать	надвить
подвивать	подвить
перевивать	перевить
передешевлять	передешевить
продешевлять	продешевить
удешевлять	удешевить
одушевлять	одушевить
воодушевлять	воодушевить
развивать	развить
взвивать	взвить
отрезвлять	отрезвить
протрезвлять	протрезвить
вытрезвлять	вытрезвить
извивать	извить
уязвлять	уязвить
изъязвлять	изъязвить
удивлять	удивить
заживлять	заживить
наживлять	наживить
вживлять	вживить
подживлять	подживить
приживлять	приживить
оживлять	оживить
отживлять	отживить
осчастливливать	осчастливить
закривлять	закривить
перекривлять	перекривить
искривлять	искривить
прививать	привить
умилостивлять	умилостивить
овивать	овить
довивать	довить
залавливать	заловить
налавливать	наловить
облавливать	обловить
подлавливать	подловить
перелавливать	переловить
излавливать	изловить
долавливать	доловить
благословлять	благословить
обусловливать	обусловить
отлавливать	отловить
улавливать	уловить
вылавливать	выловить
перестанавливать	перестановить
останавливать	остановить
приостанавливать	приостановить
постановлять	постановить
расстанавливать	расстановить
восстанавливать	восстановить
устанавливать	установить
обновлять	обновить
возобновлять	возобновить
подновлять	подновить
поновлять	поновить
вдохновлять	вдохновить
усыновлять	усыновить
повивать	повить
обескровливать	обескровить
оздоровлять	оздоровить
приноравливать	приноровить
разнайтовливать	разнайтовить
принайтовливать	принайтовить
заготавливать	заготовить
наготавливать	наготовить
подготавливать	подготовить
переподготавливать	переподготовить
изготовлять	изготовить
приготавливать	приготовить
уготовлять	уготовить
предуготовлять	предуготовить
приуготовлять	приуготовить
свивать	свить
разветвлять	разветвить
ответвлять	ответвить
отвивать	отвить
омертвлять	омертвить
умерщвлять	умертвить
отождествлять	отождествить
обожествлять	обожествить
отожествлять	отожествить
обобществлять	обобществить
овеществлять	овеществить
пресуществлять	пресуществить
осуществлять	осуществить
огосударствливать	огосударствить
очерствлять	очерствить
увивать	увить
вывивать	вывить
являть	явить
заявлять	заявить
раззявливать	раззявить
обслюнявливать	обслюнявить
проявлять	проявить
издырявливать	издырявить
продырявливать	продырявить
объявлять	объявить
предъявлять	предъявить
изъявлять	изъявить
выявлять	выявить
приваживать	привадить
поваживать	повадить
спроваживать	спровадить
отваживать	отвадить
загаживать	загадить
обгаживать	обгадить
подгаживать	подгадить
изгаживать	изгадить
угаживать	угадить
налаживать	наладить
переналаживать	переналадить
облаживать	обладить
заглаживать	загладить
наглаживать	нагладить
обглаживать	обгладить
подглаживать	подгладить
переглаживать	перегладить
разглаживать	разгладить
изглаживать	изгладить
приглаживать	пригладить
оглаживать	огладить
доглаживать	догладить
проглаживать	прогладить
сглаживать	сгладить
отглаживать	отгладить
выглаживать	выгладить
подлаживать	подладить
перелаживать	переладить
разлаживать	разладить
излаживать	изладить
прилаживать	приладить
слаживать	сладить
наслаждать	насладить
услаждать	усладить
отлаживать	отладить
улаживать	уладить
охлаждать	охладить
переохлаждать	переохладить
прохлаждать	прохладить
напомаживать	напомадить
припомаживать	припомадить
заграждать	заградить
награждать	наградить
вознаграждать	вознаградить
преграждать	преградить
ограждать	оградить
засаживать	засадить
насаждать	насадить
насаживать	насадить
обсаживать	обсадить
всаживать	всадить
надсаживать	надсадить
подсаживать	подсадить
пересаживать	пересадить
присаживать	присадить
осаживать	осадить
осаждать	осадить
осаждать	осадить
досаживать	досадить
досаждать	досадить
просаживать	просадить
ссаживать	ссадить
рассаживать	рассадить
отсаживать	отсадить
усаживать	усадить
высаживать	высадить
снабжать	снабдить
побеждать	победить
убеждать	убедить
предубеждать	предубедить
переубеждать	переубедить
разубеждать	разубедить
заслеживать	заследить
прослеживать	проследить
исслеживать	исследить
отслеживать	отследить
услеживать	уследить
выслеживать	выследить
обезвреживать	обезвредить
повреждать	повредить
подрежать	подредить
опережать	опередить
изреживать	изредить
разрежать	разредить
прореживать	проредить
упреждать	упредить
предупреждать	предупредить
учреждать	учредить
нацеживать	нацедить
вцеживать	вцедить
подцеживать	подцедить
перецеживать	перецедить
прицеживать	прицедить
оцеживать	оцедить
процеживать	процедить
сцеживать	сцедить
отцеживать	отцедить
уцеживать	уцедить
выцеживать	выцедить
заезживать	заездить
наезживать	наездить
доезживать	доездить
проезживать	проездить
проезжать	проездить
уезживать	уездить
объезжать	объездить
разъезживать	разъездить
выезживать	выездить
пригвождать	пригвоздить
загромождать	загромоздить
нагромождать	нагромоздить
взгромождать	взгромоздить
разжижать	разжидить
сжижать	сжидить
освобождать	освободить
высвобождать	высвободить
обезвоживать	обезводить
провожать	проводить
препровождать	препроводить
сопровождать	сопроводить
выпроваживать	выпроводить
вываживать	выводить
угождать	угодить
подмолаживать	подмолодить
омолаживать	омолодить
нахолаживать	нахолодить
прохолаживать	прохолодить
расхолаживать	расхолодить
выхолаживать	выхолодить
распложать	расплодить
обеспложивать	обесплодить
*	родить
зарождать	зародить
дображивать	добродить
перерождать	переродить
возрождать	возродить
загораживать	загородить
облагораживать	облагородить
нагораживать	нагородить
обгораживать	обгородить
подгораживать	подгородить
перегораживать	перегородить
разгораживать	разгородить
пригораживать	пригородить
огораживать	огородить
отгораживать	отгородить
выгораживать	выгородить
порождать	породить
урождать	уродить
нахаживать	находить
перехаживать	переходить
обихаживать	обиходить
дохаживать	доходить
расхаживать	расходить
исхаживать	исходить
отхаживать	отходить
выхаживать	выходить
затверживать	затвердить
подтверждать	подтвердить
утверждать	утвердить
вытверживать	вытвердить
науживать	наудить
возбуждать	возбудить
побуждать	побудить
пробуждать	пробудить
подзуживать	подзудить
раззуживать	раззудить
перелуживать	перелудить
вылуживать	вылудить
принуждать	принудить
понуждать	понудить
вынуждать	вынудить
сооружать	соорудить
запруживать	запрудить
перепруживать	перепрудить
натруживать	натрудить
перетруживать	перетрудить
утруждать	утрудить
засуживать	засудить
обсуждать	обсудить
присуждать	присудить
осуждать	осудить
просуживать	просудить
ссужать	ссудить
рассуживать	рассудить
отсуживать	отсудить
высуживать	высудить
застуживать	застудить
настуживать	настудить
перестуживать	перестудить
остужать	остудить
простуживать	простудить
выстуживать	выстудить
отчуждать	отчудить
выуживать	выудить
пристыжать	пристыдить
устыжать	устыдить
заряжать	зарядить
подзаряжать	подзарядить
перезаряжать	перезарядить
дозаряжать	дозарядить
наряжать	нарядить
наряжать	нарядить
занаряжать	занарядить
принаряжать	принарядить
снаряжать	снарядить
обряжать	обрядить
подряжать	подрядить
переряживать	перерядить
разряжать	разрядить
разряжать	разрядить
сряжать	срядить
отряжать	отрядить
уряжать	урядить
выряжать	вырядить
заклеивать	заклеить
наклеивать	наклеить
обклеивать	обклеить
вклеивать	вклеить
надклеивать	надклеить
подклеивать	подклеить
переклеивать	переклеить
приклеивать	приклеить
оклеивать	оклеить
доклеивать	доклеить
проклеивать	проклеить
склеивать	склеить
расклеивать	расклеить
отклеивать	отклеить
уклеивать	уклеить
выклеивать	выклеить
оевропеивать	оевропеить
заживать	зажить
заживать	зажить
ублажать	ублажить
увлажать	увлажить
отакелаживать	отакелажить
наживать	нажить
обнажать	обнажить
раздражать	раздражить
взбудораживать	взбудоражить
обескураживать	обескуражить
обживать	обжить
подживать	поджить
освежать	освежить
просвежать	просвежить
обнадеживать	обнадежить
обезнадеживать	обезнадежить
перемежать	перемежить
смежать	смежить
разнеживать	разнежить
изнеживать	изнежить
переживать	пережить
перекореживать	перекорежить
искореживать	искорежить
съеживать	съежить
изживать	изжить
обездвиживать	обездвижить
приживать	прижить
уничижать	уничижить
одалживать	одолжить
разодолжать	разодолжить
продолжать	продолжить
оживать	ожить
растревоживать	растревожить
доживать	дожить
закладывать	заложить
перезакладывать	перезаложить
налагать	наложить
накладывать	наложить
накладывать	наложить
облагать	обложить
обкладывать	обложить
вкладывать	вложить
предлагать	предложить
подкладывать	подложить
перелагать	переложить
перекладывать	переложить
перекладывать	переложить
прелагать	преложить
разлагать	разложить
раскладывать	разложить
излагать	изложить
низлагать	низложить
возлагать	возложить
прикладывать	приложить
прилагать	приложить
отволаживать	отволожить
докладывать	доложить
передокладывать	передоложить
полагать	положить
предполагать	предположить
противополагать	противоположить
рукополагать	рукоположить
располагать	расположить
предрасполагать	предрасположить
прокладывать	проложить
слагать	сложить
складывать	сложить
складывать	сложить
отлагать	отложить
откладывать	отложить
укладывать	уложить
выкладывать	выложить
растаможивать	растаможить
стреноживать	стреножить
перемножать	перемножить
размножать	размножить
помножать	помножить
умножать	умножить
преумножать	преумножить
приумножать	приумножить
завораживать	заворожить
навораживать	наворожить
обвораживать	обворожить
привораживать	приворожить
створаживать	створожить
удорожать	удорожить
настораживать	насторожить
проживать	прожить
изничтожать	изничтожить
уничтожать	уничтожить
подытоживать	подытожить
сживать	сжить
отживать	отжить
заслуживать	заслужить
наслуживать	наслужить
обслуживать	обслужить
дослуживать	дослужить
отслуживать	отслужить
услуживать	услужить
выслуживать	выслужить
обнаруживать	обнаружить
сдружать	сдружить
удружать	удружить
окружать	окружить
разоружать	разоружить
обезоруживать	обезоружить
вооружать	вооружить
перевооружать	перевооружить
довооружать	довооружить
напруживать	напружить
натуживать	натужить
выживать	выжить
выживать	выжить
размотыживать	размотыжить
заутюживать	заутюжить
наутюживать	наутюжить
подутюживать	подутюжить
переутюживать	переутюжить
разутюживать	разутюжить
проутюживать	проутюжить
отутюживать	отутюжить
прокажать	проказить
искажать	исказить
заражать	заразить
обеззараживать	обеззаразить
преображать	преобразить
обезображивать	обезобразить
изображать	изобразить
воображать	вообразить
облагоображивать	облагообразить
соображать	сообразить
отображать	отобразить
возражать	возразить
поражать	поразить
сражать	сразить
отражать	отразить
выражать	выразить
обуржуазивать	обуржуазить
приближать	приблизить
сближать	сблизить
обремизивать	обремизить
занижать	занизить
принижать	принизить
понижать	понизить
снижать	снизить
унижать	унизить
вонзать	вонзить
пронзать	пронзить
занавоживать	занавозить
унавоживать	унавозить
затормаживать	затормозить
подтормаживать	подтормозить
притормаживать	притормозить
растормаживать	растормозить
замораживать	заморозить
намораживать	наморозить
обмораживать	обморозить
вмораживать	вморозить
подмораживать	подморозить
перемораживать	переморозить
размораживать	разморозить
примораживать	приморозить
промораживать	проморозить
отмораживать	отморозить
вымораживать	выморозить
зауживать	заузить
обуживать	обузить
загружать	загрузить
нагружать	нагрузить
подгружать	подгрузить
перегружать	перегрузить
разгружать	разгрузить
догружать	догрузить
недогружать	недогрузить
погружать	погрузить
погружать	погрузить
сгружать	сгрузить
отгружать	отгрузить
выгружать	выгрузить
водружать	водрузить
суживать	сузить
офранцуживать	офранцузить
закабалять	закабалить
раскабалять	раскабалить
заваливать	завалить
наваливать	навалить
обваливать	обвалить
вваливать	ввалить
подваливать	подвалить
подваливать	подвалить
переваливать	перевалить
разваливать	развалить
взваливать	взвалить
приваливать	привалить
приваливать	привалить
проваливать	провалить
сваливать	свалить
сваливать	свалить
отваливать	отвалить
отваливать	отвалить
уваливать	увалить
захваливать	захвалить
нахваливать	нахвалить
перехваливать	перехвалить
расхваливать	расхвалить
восхвалять	восхвалить
выхваливать	выхвалить
вываливать	вывалить
засандаливать	засандалить
насандаливать	насандалить
отдалять	отдалить
удалять	удалить
изжаливать	изжалить
заливать	залить
закаливать	закалить
закаливать	закалить
накаливать	накалить
обкаливать	обкалить
подкаливать	подкалить
перекаливать	перекалить
докаливать	докалить
прокаливать	прокалить
раскалять	раскалить
оскаливать	оскалить
зашкаливать	зашкалить
выкаливать	выкалить
умалять	умалить
преумалять	преумалить
накрахмаливать	накрахмалить
подкрахмаливать	подкрахмалить
перекрахмаливать	перекрахмалить
прокрахмаливать	прокрахмалить
открахмаливать	открахмалить
выкрахмаливать	выкрахмалить
наливать	налить
запаливать	запалить
запаливать	запалить
подпаливать	подпалить
припаливать	припалить
опаливать	опалить
опаливать	опалить
пропаливать	пропалить
настропалять	настропалить
распалять	распалить
воспалять	воспалить
выпаливать	выпалить
протраливать	протралить
вытраливать	вытралить
засаливать	засалить
насаливать	насалить
обсаливать	обсалить
подсаливать	подсалить
пересаливать	пересалить
присаливать	присалить
осаливать	осалить
досаливать	досалить
просаливать	просалить
иссаливать	иссалить
усаливать	усалить
высаливать	высалить
приталивать	приталить
зачаливать	зачалить
подчаливать	подчалить
опечаливать	опечалить
перечаливать	перечалить
причаливать	причалить
размочаливать	размочалить
измочаливать	измочалить
счаливать	счалить
расчаливать	расчалить
отчаливать	отчалить
вычаливать	вычалить
обливать	облить
наскабливать	наскоблить
обскабливать	обскоблить
подскабливать	подскоблить
перескабливать	перескоблить
оскабливать	оскоблить
доскабливать	доскоблить
проскабливать	проскоблить
соскабливать	соскоблить
отскабливать	отскоблить
выскабливать	выскоблить
вливать	влить
обугливать	обуглить
подугливать	подуглить
закруглять	закруглить
подкруглять	подкруглить
округлять	округлить
скруглять	скруглить
выкруглять	выкруглить
замедлять	замедлить
умедлять	умедлить
подливать	подлить
продлевать	продлить
забеливать	забелить
подбеливать	подбелить
перебеливать	перебелить
обелять	обелить
добеливать	добелить
пробеливать	пробелить
отбеливать	отбелить
убелять	убелить
выбеливать	выбелить
расшевеливать	расшевелить
наделять	наделить
обделять	обделить
переделять	переделить
определять	определить
предопределять	предопределить
доопределять	доопределить
распределять	распределить
перераспределять	перераспределить
разделять	разделить
подразделять	подразделить
оделять	оделить
отделять	отделить
уделять	уделить
выделять	выделить
отяжелять	отяжелить
утяжелять	утяжелить
замеливать	замелить
намеливать	намелить
обмеливать	обмелить
обезземеливать	обезземелить
охмелять	охмелить
испепелять	испепелить
переливать	перелить
застреливать	застрелить
подстреливать	подстрелить
пристреливать	пристрелить
простреливать	прострелить
отстреливать	отстрелить
выстреливать	выстрелить
заселять	заселить
населять	населить
перенаселять	перенаселить
вселять	вселить
подселять	подселить
развеселять	развеселить
взвеселять	взвеселить
возвеселять	возвеселить
увеселять	увеселить
переселять	переселить
приселять	приселить
поселять	поселить
сселять	сселить
расселять	расселить
отселять	отселить
выселять	выселить
застилать	застелить
настилать	настелить
подстилать	подстелить
перестилать	перестелить
достилать	достелить
постилать	постелить
простилать	простелить
расстилать	расстелить
исстилать	исстелить
устилать	устелить
выстилать	выстелить
нацеливать	нацелить
прицеливать	прицелить
исцелять	исцелить
разливать	разлить
изливать	излить
возливать	возлить
заиливать	заилить
зажиливать	зажилить
отжиливать	отжилить
ужиливать	ужилить
умилять	умилить
запиливать	запилить
напиливать	напилить
надпиливать	надпилить
подпиливать	подпилить
перепиливать	перепилить
опиливать	опилить
допиливать	допилить
пропиливать	пропилить
остропиливать	остропилить
спиливать	спилить
распиливать	распилить
испиливать	испилить
отпиливать	отпилить
зашпиливать	зашпилить
нашпиливать	нашпилить
подшпиливать	подшпилить
перешпиливать	перешпилить
пришпиливать	пришпилить
отшпиливать	отшпилить
выпиливать	выпилить
приливать	прилить
пересиливать	пересилить
осиливать	осилить
обессиливать	обессилить
усиливать	усилить
застеклять	застеклить
остеклять	остеклить
заземлять	заземлить
приземлять	приземлить
обезболивать	обезболить
отфутболивать	отфутболить
приневоливать	приневолить
обезволивать	обезволить
соизволять	соизволить
дозволять	дозволить
позволять	позволить
вызволять	вызволить
соблаговолять	соблаговолить
увольнять	уволить
заголять	заголить
оголять	оголить
доливать	долить
недоливать	недолить
обездоливать	обездолить
замаливать	замолить
засмаливать	засмолить
насмаливать	насмолить
подсмаливать	подсмолить
пересмаливать	пересмолить
осмаливать	осмолить
досмаливать	досмолить
просмаливать	просмолить
высмаливать	высмолить
отмаливать	отмолить
умолять	умолить
вымаливать	вымолить
поливать	полить
обандероливать	обандеролить
проливать	пролить
засаливать	засолить
насаливать	насолить
обсаливать	обсолить
подсаливать	подсолить
пересаливать	пересолить
присаливать	присолить
досаливать	досолить
недосаливать	недосолить
просаливать	просолить
обессоливать	обессолить
иссаливать	иссолить
усаливать	усолить
замусоливать	замусолить
намусоливать	намусолить
обмусоливать	обмусолить
перемусоливать	перемусолить
размусоливать	размусолить
измусоливать	измусолить
засусоливать	засусолить
обсусоливать	обсусолить
высаливать	высолить
утолять	утолить
ухоливать	ухолить
выхоливать	выхолить
затепливать	затеплить
отеплять	отеплить
утеплять	утеплить
насверливать	насверлить
надсверливать	надсверлить
досверливать	досверлить
просверливать	просверлить
рассверливать	рассверлить
иссверливать	иссверлить
высверливать	высверлить
сливать	слить
замасливать	замаслить
намасливать	намаслить
обмасливать	обмаслить
подмасливать	подмаслить
перемасливать	перемаслить
измасливать	измаслить
примасливать	примаслить
промасливать	промаслить
умасливать	умаслить
подкислять	подкислить
перекислять	перекислить
окислять	окислить
окислять	окислить
зачислять	зачислить
начислять	начислить
перечислять	перечислить
причислять	причислить
сопричислять	сопричислить
счислять	счислить
расчислять	расчислить
исчислять	исчислить
отчислять	отчислить
вычислять	вычислить
замусливать	замуслить
намусливать	намуслить
обмусливать	обмуслить
измусливать	измуслить
засусливать	засуслить
насусливать	насуслить
замышлять	замыслить
измышлять	измыслить
примышлять	примыслить
домысливать	домыслить
помышлять	помыслить
промышлять	промыслить
осмысливать	осмыслить
переосмысливать	переосмыслить
обессмысливать	обессмыслить
умышлять	умыслить
вымышлять	вымыслить
осветлять	осветлить
просветлять	просветлить
высветлять	высветлить
отливать	отлить
растлевать	растлить
подкарауливать	подкараулить
прокарауливать	прокараулить
укарауливать	укараулить
зажуливать	зажулить
обжуливать	обжулить
заруливать	зарулить
подруливать	подрулить
прируливать	прирулить
отруливать	отрулить
выруливать	вырулить
обмишуливать	обмишулить
зачехлять	зачехлить
расчехлять	расчехлить
нахохливать	нахохлить
подрыхлять	подрыхлить
перерыхлять	перерыхлить
разрыхлять	разрыхлить
взрыхлять	взрыхлить
опошлять	опошлить
выливать	вылить
намыливать	намылить
обмыливать	обмылить
подмыливать	подмылить
перемыливать	перемылить
взмыливать	взмылить
измыливать	измылить
смыливать	смылить
вымыливать	вымылить
опылять	опылить
опыливать	опылить
переопылять	переопылить
распылять	распылить
окрылять	окрылить
обескрыливать	обескрылить
воскрылять	воскрылить
отъюливать	отъюлить
завяливать	завялить
навяливать	навялить
обвяливать	обвялить
подвяливать	подвялить
перевяливать	перевялить
провяливать	провялить
вывяливать	вывялить
напяливать	напялить
впяливать	впялить
спяливать	спялить
распяливать	распялить
отпяливать	отпялить
выпяливать	выпялить
захламливать	захламить
обрамлять	обрамить
обрамлять	обрамить
посрамлять	посрамить
устремлять	устремить
защемлять	защемить
прищемлять	прищемить
расщемлять	расщемить
отщемлять	отщемить
ущемлять	ущемить
окаймлять	окаймить
осведомлять	осведомить
уведомлять	уведомить
предуведомлять	предуведомить
раззнакомливать	раззнакомить
ознакомлять	ознакомить
заламывать	заломить
обламывать	обломить
надламывать	надломить
подламывать	подломить
переламывать	переломить
преломлять	преломить
ошеломлять	ошеломить
разламывать	разломить
доламывать	доломить
проламывать	проломить
сламывать	сломить
отламывать	отломить
выламывать	выломить
притомлять	притомить
истомлять	истомить
утомлять	утомить
переутомлять	переутомить
закармливать	закормить
обкармливать	обкормить
подкармливать	подкормить
перекармливать	перекормить
прикармливать	прикормить
окармливать	окормить
докармливать	докормить
недокармливать	недокормить
прокармливать	прокормить
скармливать	скормить
раскармливать	раскормить
вскармливать	вскормить
искармливать	искормить
откармливать	откормить
выкармливать	выкормить
оформлять	оформить
переоформлять	переоформить
затмевать	затмить
образумливать	образумить
вразумлять	вразумить
изумлять	изумить
надоумливать	надоумить
спрямлять	спрямить
распрямлять	распрямить
испрямлять	испрямить
выпрямлять	выпрямить
подтабанивать	подтабанить
оболванивать	оболванить
запоганивать	запоганить
опоганивать	опоганить
испоганивать	испоганить
начеканивать	начеканить
подчеканивать	подчеканить
перечеканивать	перечеканить
прочеканивать	прочеканить
счеканивать	счеканить
расчеканивать	расчеканить
отчеканивать	отчеканить
вычеканивать	вычеканить
заарканивать	заарканить
заманивать	заманить
подманивать	подманить
переманивать	переманить
разманивать	разманить
взманивать	взманить
приманивать	приманить
прикарманивать	прикарманить
задурманивать	задурманить
одурманивать	одурманить
сманивать	сманить
отманивать	отманить
уманивать	уманить
затуманивать	затуманить
отуманивать	отуманить
выманивать	выманить
протаранивать	протаранить
возбранять	возбранить
огранивать	огранить
выгранивать	выгранить
подранивать	подранить
затиранивать	затиранить
распространять	распространить
отстранять	отстранить
устранять	устранить
охранять	охранить
предохранять	предохранить
сохранять	сохранить
сравнивать	сравнить
загнивать	загнить
нагнивать	нагнить
обгнивать	обгнить
надгнивать	надгнить
подгнивать	подгнить
перегнивать	перегнить
изгнивать	изгнить
догнивать	догнить
прогнивать	прогнить
сгнивать	сгнить
отгнивать	отгнить
выгнивать	выгнить
обеднять	обеднить
усреднять	усреднить
упразднять	упразднить
заводнять	заводнить
наводнять	наводнить
обводнять	обводнить
затруднять	затруднить
утруднять	утруднить
защебенивать	защебенить
расщебенивать	расщебенить
оказенивать	оказенить
озеленять	озеленить
пленять	пленить
сочленять	сочленить
расчленять	расчленить
отчленять	отчленить
вычленять	вычленить
заменять	заменить
воспламенять	воспламенить
обменивать	обменить
вменять	вменить
подменивать	подменить
обременять	обременить
переобременять	переобременить
осовременивать	осовременить
переменять	переменить
обсеменять	обсеменить
осеменять	осеменить
изменять	изменить
изменять	изменить
видоизменять	видоизменить
применять	применить
сменять	сменить
отменять	отменить
остепенять	остепенить
вспенивать	вспенить
накренять	накренить
вкоренять	вкоренить
искоренять	искоренить
укоренять	укоренить
осенять	осенить
затенять	затенить
оттенять	оттенить
наценивать	наценить
переценивать	переценить
оценивать	оценить
переоценивать	переоценить
недооценивать	недооценить
расценивать	расценить
обесценивать	обесценить
уценивать	уценить
увлажнять	увлажнить
переувлажнять	переувлажнить
осложнять	осложнить
усложнять	усложнить
опорожнять	опорожнить
опорожнять	опорожнить
выпоражнивать	выпорожнить
соблазнять	соблазнить
поддразнивать	поддразнить
передразнивать	передразнить
раздразнивать	раздразнить
разрознивать	разрознить
загрязнять	загрязнить
изгрязнять	изгрязнить
обвинять	обвинить
извинять	извинить
ополовинивать	ополовинить
соединять	соединить
подсоединять	подсоединить
присоединять	присоединить
воссоединять	воссоединить
отсоединять	отсоединить
уединять	уединить
объединять	объединить
разъединять	разъединить
отъединять	отъединить
напружинивать	напружинить
прорезинивать	прорезинить
удлинять	удлинить
заклинивать	заклинить
заклинивать	заклинить
вклинивать	вклинить
вклинивать	вклинить
подклинивать	подклинить
подклинивать	подклинить
переклинивать	переклинить
переклинивать	переклинить
расклинивать	расклинить
расклинивать	расклинить
засинивать	засинить
насинивать	насинить
подсинивать	подсинить
пересинивать	пересинить
просинивать	просинить
высинивать	высинить
ощетинивать	ощетинить
зачинивать	зачинить
начинять	начинить
начинивать	начинить
обчинивать	обчинить
вчинять	вчинить
подчинять	подчинить
переподчинять	переподчинить
соподчинять	соподчинить
перечинивать	перечинить
причинять	причинить
дочинивать	дочинить
починять	починить
сочинять	сочинить
пересочинять	пересочинить
присочинять	присочинить
учинять	учинить
заполнять	заполнить
наполнять	наполнить
переполнять	переполнить
дополнять	дополнить
пополнять	пополнить
исполнять	исполнить
преисполнять	преисполнить
восполнять	восполнить
выполнять	выполнить
перевыполнять	перевыполнить
недовыполнять	недовыполнить
затемнять	затемнить
притемнять	притемнить
утемнять	утемнить
запоминать	запомнить
напоминать	напомнить
припоминать	припомнить
вспоминать	вспомнить
обзванивать	обзвонить
перезванивать	перезвонить
раззванивать	раззвонить
прозванивать	прозвонить
отзванивать	отзвонить
вызванивать	вызвонить
урезонивать	урезонить
узаконивать	узаконить
раздраконивать	раздраконить
наклонять	наклонить
преклонять	преклонить
приклонять	приклонить
склонять	склонить
отклонять	отклонить
уклонять	уклонить
заполонять	заполонить
заслонять	заслонить
прислонять	прислонить
отслонять	отслонить
угомонять	угомонить
засупонивать	засупонить
пересупонивать	пересупонить
присупонивать	присупонить
рассупонивать	рассупонить
заронять	заронить
переборанивать	переборонить
оборонять	оборонить
проборанивать	проборонить
проворонивать	проворонить
распатронивать	распатронить
перефасонивать	перефасонить
утонять	утонить
укрупнять	укрупнить
разукрупнять	разукрупнить
осквернять	осквернить
обдернять	обдернить
зачернять	зачернить
начернять	начернить
перечернять	перечернить
очернять	очернить
опреснять	опреснить
затеснять	затеснить
втеснять	втеснить
притеснять	притеснить
стеснять	стеснить
оттеснять	оттеснить
утеснять	утеснить
вытеснять	вытеснить
вытиснять	вытиснить
пояснять	пояснить
прояснивать	прояснить
прояснять	прояснить
уяснять	уяснить
объяснять	объяснить
разъяснивать	разъяснить
разъяснять	разъяснить
изъяснять	изъяснить
выяснять	выяснить
выяснивать	выяснить
уплотнять	уплотнить
переуплотнять	переуплотнить
загарпунивать	загарпунить
подтрунивать	подтрунить
приструнивать	приструнить
приструнивать	приструнить
сострунивать	сострунить
сострунивать	сострунить
упрочнять	упрочнить
уточнять	уточнить
утучнять	утучнить
одомашнивать	одомашнить
заслюнивать	заслюнить
наслюнивать	наслюнить
обслюнивать	обслюнить
исслюнивать	исслюнить
отслюнивать	отслюнить
зарумянивать	зарумянить
нарумянивать	нарумянить
подрумянивать	подрумянить
перерумянивать	перерумянить
разрумянивать	разрумянить
опьянять	опьянить
передваивать	передвоить
раздваивать	раздвоить
вздваивать	вздвоить
вздваивать	вздвоить
сдваивать	сдвоить
сдваивать	сдвоить
сдваивать	сдвоить
сдваивать	сдвоить
удваивать	удвоить
присваивать	присвоить
осваивать	освоить
усваивать	усвоить
надаивать	надоить
передаивать	передоить
раздаивать	раздоить
издаивать	издоить
сдаивать	сдоить
отдаивать	отдоить
выдаивать	выдоить
успокаивать	успокоить
упокоевать	упокоить
наслаивать	наслоить
подслаивать	подслоить
переслаивать	переслоить
прослаивать	прослоить
расслаивать	расслоить
отслаивать	отслоить
загнаивать	загноить
нагнаивать	нагноить
подгнаивать	подгноить
перегнаивать	перегноить
сгнаивать	сгноить
запаивать	запоить
напаивать	напоить
напаивать	напоить
подпаивать	подпоить
перепаивать	перепоить
опаивать	опоить
допаивать	допоить
пропаивать	пропоить
спаивать	споить
вспаивать	вспоить
испаивать	испоить
отпаивать	отпоить
упаивать	упоить
выпаивать	выпоить
закраивать	закроить
накраивать	накроить
вкраивать	вкроить
подкраивать	подкроить
перекраивать	перекроить
прикраивать	прикроить
докраивать	докроить
раскраивать	раскроить
искраивать	искроить
откраивать	откроить
выкраивать	выкроить
страивать	строить
застраивать	застроить
настраивать	настроить
перенастраивать	перенастроить
обстраивать	обстроить
встраивать	встроить
надстраивать	надстроить
подстраивать	подстроить
перестраивать	перестроить
пристраивать	пристроить
достраивать	достроить
недостраивать	недостроить
расстраивать	расстроить
отстраивать	отстроить
устраивать	устроить
обустраивать	обустроить
переустраивать	переустроить
благоустраивать	благоустроить
трудоустраивать	трудоустроить
выстраивать	выстроить
утраивать	утроить
вытраивать	вытроить
удостаивать	удостоить
запивать	запить
запивать	запить
облапливать	облапить
напивать	напить
вкрапливать	вкрапить
обпивать	обпить
впивать	впить
надпивать	надпить
залеплять	залепить
налеплять	налепить
облеплять	облепить
влеплять	влепить
подлеплять	подлепить
перелеплять	перелепить
разлеплять	разлепить
прилеплять	прилепить
долеплять	долепить
слеплять	слепить
заслеплять	заслепить
ослеплять	ослепить
отлеплять	отлепить
улеплять	улепить
вылепливать	вылепить
перепивать	перепить
закреплять	закрепить
подкреплять	подкрепить
перекреплять	перекрепить
прикреплять	прикрепить
скреплять	скрепить
раскреплять	раскрепить
откреплять	открепить
укреплять	укрепить
зацеплять	зацепить
нацеплять	нацепить
подцеплять	подцепить
перецеплять	перецепить
прицеплять	прицепить
оцеплять	оцепить
сцеплять	сцепить
расцеплять	расцепить
отцеплять	отцепить
уцеплять	уцепить
защеплять	защепить
прищеплять	прищепить
расщеплять	расщепить
отщеплять	отщепить
опивать	опить
допивать	допить
недопивать	недопить
накапливать	накопить
подкапливать	подкопить
прикапливать	прикопить
скапливать	скопить
оскоплять	оскопить
окроплять	окропить
уторапливать	уторопить
пропивать	пропить
затапливать	затопить
затоплять	затопить
натапливать	натопить
обтапливать	обтопить
подтапливать	подтопить
подтоплять	подтопить
перетапливать	перетопить
отапливать	отопить
дотапливать	дотопить
потоплять	потопить
протапливать	протопить
стапливать	стопить
растапливать	растопить
истапливать	истопить
оттапливать	оттопить
утапливать	утопить
вытапливать	вытопить
спивать	спить
распивать	распить
испивать	испить
отпивать	отпить
покупать	купить
закупать	закупить
накупать	накупить
подкупать	подкупить
перекупать	перекупить
прикупать	прикупить
окупать	окупить
совокуплять	совокупить
присовокуплять	присовокупить
докупать	докупить
скупать	скупить
раскупать	раскупить
искупать	искупить
откупать	откупить
выкупать	выкупить
залуплять	залупить
облупливать	облупить
оглуплять	оглупить
надлупливать	надлупить
подлупливать	подлупить
слупливать	слупить
вылупливать	вылупить
насупливать	насупить
затуплять	затупить
притуплять	притупить
отуплять	отупить
потуплять	потупить
ступать	ступить
заступать	заступить
наступать	наступить
обступать	обступить
вступать	вступить
подступать	подступить
переступать	переступить
преступать	преступить
приступать	приступить
поступать	поступить
проступать	проступить
отступать	отступить
уступать	уступить
переуступать	переуступить
выступать	выступить
выпивать	выпить
усыплять	усыпить
заваривать	заварить
наваривать	наварить
обваривать	обварить
вваривать	вварить
предварять	предварить
подваривать	подварить
переваривать	переварить
разваривать	разварить
взваривать	взварить
приваривать	приварить
доваривать	доварить
недоваривать	недоварить
проваривать	проварить
затоваривать	затоварить
отоваривать	отоварить
сваривать	сварить
отваривать	отварить
уваривать	уварить
вываривать	выварить
раскочегаривать	раскочегарить
задаривать	задарить
надаривать	надарить
передаривать	передарить
раздаривать	раздарить
одаривать	одарить
одарять	одарить
отдаривать	отдарить
ударять	ударить
приударять	приударить
зажаривать	зажарить
нажаривать	нажарить
обжаривать	обжарить
поджаривать	поджарить
пережаривать	пережарить
прижаривать	прижарить
дожаривать	дожарить
недожаривать	недожарить
прожаривать	прожарить
отжаривать	отжарить
ужаривать	ужарить
выжаривать	выжарить
разбазаривать	разбазарить
озарять	озарить
запаривать	запарить
напаривать	напарить
перепаривать	перепарить
припаривать	припарить
допаривать	допарить
пропаривать	пропарить
спаривать	спарить
распаривать	распарить
вспаривать	вспарить
испарять	испарить
воспарять	воспарить
отпаривать	отпарить
упаривать	упарить
нашпаривать	нашпарить
ошпаривать	ошпарить
вышпаривать	вышпарить
выпаривать	выпарить
затаривать	затарить
засахаривать	засахарить
насахаривать	насахарить
обсахаривать	обсахарить
подсахаривать	подсахарить
пересахаривать	пересахарить
присахаривать	присахарить
обессахаривать	обессахарить
усахаривать	усахарить
нашаривать	нашарить
обшаривать	обшарить
перешаривать	перешарить
вышаривать	вышарить
забривать	забрить
нафабривать	нафабрить
прифабривать	прифабрить
пришабривать	пришабрить
сшабривать	сшабрить
подбривать	подбрить
перебривать	перебрить
подтибривать	подтибрить
обривать	обрить
добривать	добрить
задабривать	задобрить
раздабривать	раздобрить
одобрять	одобрить
сдабривать	сдобрить
удобрять	удобрить
пробривать	пробрить
сбривать	сбрить
отбривать	отбрить
зазубривать	зазубрить
назубривать	назубрить
подзубривать	подзубрить
иззубривать	иззубрить
прозубривать	прозубрить
вызубривать	вызубрить
выбривать	выбрить
забагривать	забагрить
набагривать	набагрить
обагрять	обагрить
сбагривать	сбагрить
разведривать	разведрить
выведривать	выведрить
внедрять	внедрить
подбодрять	подбодрить
взбадривать	взбодрить
ободрять	ободрить
приободрять	приободрить
умудрять	умудрить
запудривать	запудрить
напудривать	напудрить
подпудривать	подпудрить
припудривать	припудрить
заверять	заверить
вверять	вверить
доверять	доверить
передоверять	передоверить
поверять	поверить
проверять	проверить
перепроверять	перепроверить
удостоверять	удостоверить
сверять	сверить
учетверять	учетверить
уверять	уверить
разуверять	разуверить
выверять	выверить
замеривать	замерить
намеривать	намерить
обмеривать	обмерить
перемеривать	перемерить
усемерять	усемерить
размеривать	размерить
соразмерять	соразмерить
измерять	измерить
соизмерять	соизмерить
примеривать	примерить
домеривать	домерить
недомеривать	недомерить
промеривать	промерить
отмеривать	отмерить
умерять	умерить
вымеривать	вымерить
вперять	вперить
оперять	оперить
ушестерять	ушестерить
удевятерять	удевятерить
упятерять	упятерить
удесятерять	удесятерить
удочерять	удочерить
ощеривать	ощерить
заподазривать	заподозрить
обезжиривать	обезжирить
протранжиривать	протранжирить
растранжиривать	растранжирить
прожиривать	прожирить
замирять	замирить
примирять	примирить
утихомиривать	утихомирить
смирять	смирить
присмирять	присмирить
усмирять	усмирить
умирять	умирить
расширять	расширить
уширять	уширить
присборивать	присборить
водворять	водворить
выдворять	выдворить
заговаривать	заговорить
наговаривать	наговорить
обговаривать	обговорить
подговаривать	подговорить
переговаривать	переговорить
разговаривать	разговорить
приговаривать	приговорить
оговаривать	оговорить
договаривать	договорить
недоговаривать	недоговорить
проговаривать	проговорить
сговаривать	сговорить
отговаривать	отговорить
уговаривать	уговорить
выговаривать	выговорить
затворять	затворить
удовлетворять	удовлетворить
претворять	претворить
олицетворять	олицетворить
притворять	притворить
отворять	отворить
оживотворять	оживотворить
ублаготворять	ублаготворить
обоготворять	обоготворить
оплодотворять	оплодотворить
приотворять	приотворить
умиротворять	умиротворить
одухотворять	одухотворить
створять	створить
растворять	растворить
растворять	растворить
вытворять	вытворить
объегоривать	объегорить
подзадоривать	подзадорить
раззадоривать	раззадорить
зашпандоривать	зашпандорить
пришпандоривать	пришпандорить
отшпандоривать	отшпандорить
разорять	разорить
окорять	окорить
покорять	покорить
ускорять	ускорить
укорять	укорить
замаривать	заморить
подмаривать	подморить
размаривать	разморить
смаривать	сморить
вымаривать	выморить
застопоривать	застопорить
переспоривать	переспорить
оспаривать	оспорить
проспоривать	проспорить
отспаривать	отспорить
выспаривать	выспорить
закупоривать	закупорить
раскупоривать	раскупорить
откупоривать	откупорить
укупоривать	укупорить
пришпоривать	пришпорить
засорять	засорить
рассоривать	рассорить
подрессоривать	подрессорить
замусоривать	замусорить
повторять	повторить
проторять	проторить
зашторивать	зашторить
зашоривать	зашорить
обветривать	обветрить
проветривать	проветрить
выветривать	выветрить
распестрять	распестрить
испестрять	испестрить
упестрять	упестрить
заострять	заострить
обострять	обострить
изострять	изострить
убыстрять	убыстрить
забуривать	забурить
разбуривать	разбурить
пробуривать	пробурить
выбуривать	выбурить
задуривать	задурить
обдуривать	обдурить
наглазуривать	наглазурить
закуривать	закурить
накуривать	накурить
обкуривать	обкурить
подкуривать	подкурить
перекуривать	перекурить
прикуривать	прикурить
окуривать	окурить
докуривать	докурить
прокуривать	прокурить
скуривать	скурить
раскуривать	раскурить
искуривать	искурить
воскурять	воскурить
зашкуривать	зашкурить
ошкуривать	ошкурить
выкуривать	выкурить
зажмуривать	зажмурить
нахмуривать	нахмурить
охмурять	охмурить
изнурять	изнурить
окарикатуривать	окарикатурить
заштукатуривать	заштукатурить
наштукатуривать	наштукатурить
подштукатуривать	подштукатурить
перештукатуривать	перештукатурить
оштукатуривать	оштукатурить
выштукатуривать	выштукатурить
олитературивать	олитературить
подхалтуривать	подхалтурить
вытуривать	вытурить
окультуривать	окультурить
обмишуривать	обмишурить
защуривать	защурить
прищуривать	прищурить
сощуривать	сощурить
испещрять	испещрить
изощрять	изощрить
поощрять	поощрить
запузыривать	запузырить
обшныривать	обшнырить
растопыривать	растопырить
оттопыривать	оттопырить
разъярять	разъярить
заквашивать	заквасить
наквашивать	наквасить
подквашивать	подквасить
переквашивать	переквасить
доквашивать	доквасить
недоквашивать	недоквасить
проквашивать	проквасить
сквашивать	сквасить
расквашивать	расквасить
загашать	загасить
пригашать	пригасить
погашать	погасить
угашать	угасить
разглашать	разгласить
возглашать	возгласить
провозглашать	провозгласить
приглашать	пригласить
оглашать	огласить
соглашать	согласить
закрашивать	закрасить
накрашивать	накрасить
обкрашивать	обкрасить
подкрашивать	подкрасить
перекрашивать	перекрасить
прикрашивать	прикрасить
окрашивать	окрасить
докрашивать	докрасить
прокрашивать	прокрасить
скрашивать	скрасить
раскрашивать	раскрасить
искрашивать	искрасить
открашивать	открасить
украшать	украсить
разукрашивать	разукрасить
изукрашивать	изукрасить
приукрашивать	приукрасить
выкрашивать	выкрасить
завешивать	завесить
навешивать	навесить
занавешивать	занавесить
обвешивать	обвесить
подвешивать	подвесить
перевешивать	перевесить
развешивать	развесить
взвешивать	взвесить
привешивать	привесить
довешивать	довесить
недовешивать	недовесить
уравновешивать	уравновесить
провешивать	провесить
свешивать	свесить
отвешивать	отвесить
увешивать	увесить
вывешивать	вывесить
обезлесивать	обезлесить
замешивать	замесить
намешивать	намесить
вмешивать	вмесить
подмешивать	подмесить
перемешивать	перемесить
размешивать	размесить
примешивать	примесить
домешивать	домесить
промешивать	промесить
смешивать	смесить
умешивать	умесить
вымешивать	вымесить
воскрешать	воскресить
закашивать	закосить
закашивать	закосить
накашивать	накосить
обкашивать	обкосить
подкашивать	подкосить
перекашивать	перекосить
перекашивать	перекосить
окашивать	окосить
докашивать	докосить
прокашивать	прокосить
скашивать	скосить
скашивать	скосить
раскашивать	раскосить
раскашивать	раскосить
раскашивать	раскосить
выкашивать	выкосить
занашивать	заносить
нанашивать	наносить
обнашивать	обносить
поднашивать	подносить
перенашивать	переносить
разнашивать	разносить
изнашивать	износить
донашивать	доносить
пронашивать	проносить
снашивать	сносить
вынашивать	выносить
бросать	бросить
забрасывать	забросить
набрасывать	набросить
вбрасывать	вбросить
подбрасывать	подбросить
перебрасывать	перебросить
разбрасывать	разбросить
взбрасывать	взбросить
прибрасывать	прибросить
добрасывать	добросить
пробрасывать	пробросить
сбрасывать	сбросить
отбрасывать	отбросить
выбрасывать	выбросить
орошать	оросить
запрашивать	запросить
напрашивать	напросить
перепрашивать	перепросить
припрашивать	припросить
опрашивать	опросить
вопрошать	вопросить
допрашивать	допросить
передопрашивать	передопросить
спрашивать	спросить
переспрашивать	переспросить
испрашивать	испросить
расспрашивать	расспросить
выспрашивать	выспросить
отпрашивать	отпросить
упрашивать	упросить
выпрашивать	выпросить
закусывать	закусить
обкусывать	обкусить
вкушать	вкусить
предвкушать	предвкусить
надкусывать	надкусить
подкусывать	подкусить
перекусывать	перекусить
прикусывать	прикусить
прокусывать	прокусить
скусывать	скусить
раскусывать	раскусить
искушать	искусить
откусывать	откусить
выкусывать	выкусить
натрушивать	натрусить
перетрушивать	перетрусить
струшивать	струсить
раструшивать	раструсить
вытрушивать	вытрусить
завышать	завысить
подвышать	подвысить
превышать	превысить
возвышать	возвысить
превозвышать	превозвысить
повышать	повысить
хватать	хватить
хватать	хватить
захватывать	захватить
обхватывать	обхватить
подхватывать	подхватить
перехватывать	перехватить
прихватывать	прихватить
охватывать	охватить
прохватывать	прохватить
схватывать	схватить
расхватывать	расхватить
отхватывать	отхватить
ухватывать	ухватить
выхватывать	выхватить
загачивать	загатить
загачивать	загатить
нагачивать	нагатить
нагачивать	нагатить
обогащать	обогатить
выгачивать	выгатить
закатывать	закатить
накатывать	накатить
обкатывать	обкатить
вкатывать	вкатить
подкатывать	подкатить
перекатывать	перекатить
прикатывать	прикатить
окатывать	окатить
докатывать	докатить
прокатывать	прокатить
скатывать	скатить
скатывать	скатить
раскатывать	раскатить
вскатывать	вскатить
откатывать	откатить
укатывать	укатить
выкатывать	выкатить
позлащать	позлатить
переплачивать	переплатить
приплачивать	приплатить
оплачивать	оплатить
доплачивать	доплатить
недоплачивать	недоплатить
отплачивать	отплатить
уплачивать	уплатить
выплачивать	выплатить
всхохлачивать	всхохлатить
раскосмачивать	раскосматить
вскосмачивать	вскосматить
разлохмачивать	разлохматить
взлохмачивать	взлохматить
перелопачивать	перелопатить
законопачивать	законопатить
переконопачивать	переконопатить
оконопачивать	оконопатить
проконопачивать	проконопатить
расконопачивать	расконопатить
исконопачивать	исконопатить
отконопачивать	отконопатить
выконопачивать	выконопатить
обращать	обратить
превращать	превратить
развращать	развратить
извращать	извратить
возвращать	возвратить
совращать	совратить
отвращать	отвратить
предотвращать	предотвратить
прекращать	прекратить
обюрокрачивать	обюрократить
сокращать	сократить
подсокращать	подсократить
затрачивать	затратить
перетрачивать	перетратить
растрачивать	растратить
истрачивать	истратить
утрачивать	утратить
привечать	приветить
засвечивать	засветить
подсвечивать	подсветить
освещать	осветить
освещать	осветить
просвещать	просветить
просвечивать	просветить
высвечивать	высветить
отвечать	ответить
подцвечивать	подцветить
расцвечивать	расцветить
обесцвечивать	обесцветить
отцвечивать	отцветить
замечать	заметить
намечать	наметить
обмечать	обметить
подмечать	подметить
перемечать	переметить
размечать	разметить
примечать	приметить
помечать	пометить
отмечать	отметить
вымечать	выметить
засекречивать	засекретить
рассекречивать	рассекретить
запрещать	запретить
воспрещать	воспретить
встречать	встретить
посещать	посетить
зарешечивать	зарешетить
зарешечивать	зарешетить
обрешечивать	обрешетить
подрешечивать	подрешетить
изрешечивать	изрешетить
намагничивать	намагнитить
размагничивать	размагнитить
похищать	похитить
расхищать	расхитить
восхищать	восхитить
восхищать	восхитить
предвосхищать	предвосхитить
ухичивать	ухитить
защищать	защитить
сболчивать	сболтить
завинчивать	завинтить
навинчивать	навинтить
ввинчивать	ввинтить
подвинчивать	подвинтить
перевинчивать	перевинтить
развинчивать	развинтить
взвинчивать	взвинтить
извинчивать	извинтить
привинчивать	привинтить
довинчивать	довинтить
провинчивать	провинтить
свинчивать	свинтить
отвинчивать	отвинтить
увинчивать	увинтить
вывинчивать	вывинтить
озабочивать	озаботить
порабощать	поработить
отягощать	отяготить
облокачивать	облокотить
поглощать	поглотить
проглатывать	проглотить
заболачивать	заболотить
перезолачивать	перезолотить
раззолачивать	раззолотить
вызолачивать	вызолотить
заколачивать	заколотить
наколачивать	наколотить
обколачивать	обколотить
вколачивать	вколотить
подколачивать	подколотить
переколачивать	переколотить
приколачивать	приколотить
околачивать	околотить
доколачивать	доколотить
проколачивать	проколотить
сколачивать	сколотить
расколачивать	расколотить
исколачивать	исколотить
отколачивать	отколотить
уколачивать	уколотить
выколачивать	выколотить
замолачивать	замолотить
намолачивать	намолотить
обмолачивать	обмолотить
перемолачивать	перемолотить
размолачивать	размолотить
измолачивать	измолотить
примолачивать	примолотить
домолачивать	домолотить
промолачивать	промолотить
смолачивать	смолотить
отмолачивать	отмолотить
умолачивать	умолотить
вымолачивать	вымолотить
воплощать	воплотить
перевоплощать	перевоплотить
сплачивать	сплотить
укрощать	укротить
оборачивать	оборотить
заворачивать	заворотить
наворачивать	наворотить
вворачивать	вворотить
подворачивать	подворотить
переворачивать	переворотить
разворачивать	разворотить
приворачивать	приворотить
поворачивать	поворотить
проворачивать	проворотить
сворачивать	своротить
отворачивать	отворотить
выворачивать	выворотить
окорачивать	окоротить
укорачивать	укоротить
разохочивать	разохотить
приохочивать	приохотить
закапчивать	закоптить
накапчивать	накоптить
подкапчивать	подкоптить
перекапчивать	перекоптить
докапчивать	докоптить
прокапчивать	прокоптить
выкапчивать	выкоптить
зачерчивать	зачертить
начерчивать	начертить
вчерчивать	вчертить
подчерчивать	подчертить
перечерчивать	перечертить
причерчивать	причертить
очерчивать	очертить
дочерчивать	дочертить
прочерчивать	прочертить
счерчивать	счертить
расчерчивать	расчертить
исчерчивать	исчертить
отчерчивать	отчертить
вычерчивать	вычертить
залащивать	заластить
заслащивать	засластить
наслащивать	насластить
подслащивать	подсластить
переслащивать	пересластить
услащать	усластить
улащивать	уластить
намащивать	намастить
умащать	умастить
переснащивать	переснастить
оснащать	оснастить
переоснащать	переоснастить
расснащивать	расснастить
уснащать	уснастить
заращивать	зарастить
наращивать	нарастить
подращивать	подрастить
разращивать	разрастить
взращивать	взрастить
приращивать	прирастить
доращивать	дорастить
проращивать	прорастить
сращивать	срастить
отращивать	отрастить
пристращать	пристрастить
выращивать	вырастить
причащать	причастить
учащать	участить
навещать	навестить
извещать	известить
возвещать	возвестить
предвозвещать	предвозвестить
провозвещать	провозвестить
повещать	повестить
оповещать	оповестить
усовещивать	усовестить
улещивать	улестить
замещать	заместить
вмещать	вместить
совмещать	совместить
перемещать	переместить
размещать	разместить
возмещать	возместить
помещать	поместить
смещать	сместить
умещать	уместить
вымещать	выместить
перекрещивать	перекрестить
скрещивать	скрестить
выкрещивать	выкрестить
обесчещивать	обесчестить
зачищать	зачистить
начищать	начистить
обчищать	обчистить
подчищать	подчистить
перечищать	перечистить
очищать	очистить
дочищать	дочистить
прочищать	прочистить
счищать	счистить
расчищать	расчистить
отчищать	отчистить
вычищать	вычистить
утолщать	утолстить
отмщать	отмстить
отомщать	отомстить
угощать	угостить
скащивать	скостить
охолащивать	охолостить
выхолащивать	выхолостить
замащивать	замостить
намащивать	намостить
подмащивать	подмостить
перемащивать	перемостить
взмащивать	взмостить
примащивать	примостить
домащивать	домостить
промащивать	промостить
умащивать	умостить
вымащивать	вымостить
закрепощать	закрепостить
раскрепощать	раскрепостить
прощать	простить
опрощать	опростить
упрощать	упростить
наущать	наустить
подгущать	подгустить
сгущать	сгустить
подущать	подустить
пускать	пустить
запускать	запустить
напускать	напустить
впускать	впустить
подпускать	подпустить
перепускать	перепустить
припускать	припустить
опускать	опустить
допускать	допустить
попускать	попустить
пропускать	пропустить
спускать	спустить
распускать	распустить
испускать	испустить
ниспускать	ниспустить
приспускать	приспустить
отпускать	отпустить
упускать	упустить
выпускать	выпустить
прельщать	прельстить
обольщать	обольстить
забучивать	забутить
набучивать	набутить
выбучивать	выбутить
прокучивать	прокутить
взмучивать	взмутить
возмущать	возмутить
промучивать	промутить
смущать	смутить
отмучивать	отмутить
закручивать	закрутить
накручивать	накрутить
обкручивать	обкрутить
вкручивать	вкрутить
подкручивать	подкрутить
перекручивать	перекрутить
прикручивать	прикрутить
окручивать	окрутить
докручивать	докрутить
прокручивать	прокрутить
скручивать	скрутить
раскручивать	раскрутить
искручивать	искрутить
откручивать	открутить
укручивать	укрутить
выкручивать	выкрутить
нартучивать	нартутить
подшучивать	подшутить
вышучивать	вышутить
ощущать	ощутить
предощущать	предощутить
насыщать	насытить
перенасыщать	перенасытить
пересыщать	пересытить
пресыщать	пресытить
освящать	освятить
посвящать	посвятить
запячивать	запятить
напячивать	напятить
впячивать	впятить
выпячивать	выпятить
переграфлять	переграфить
разграфлять	разграфить
прографлять	прографить
отграфлять	отграфить
потрафлять	потрафить
зарифлять	зарифить
засобачивать	засобачить
всобачивать	всобачить
присобачивать	присобачить
озадачивать	озадачить
облачать	облачить
разоблачать	разоблачить
раскулачивать	раскулачить
подначивать	подначить
назначать	назначить
предназначать	предназначить
переназначать	переназначить
означать	означить
обозначать	обозначить
переиначивать	переиначить
околпачивать	околпачить
омрачать	омрачить
помрачать	помрачить
одурачивать	одурачить
подсачивать	подсачить
облегчать	облегчить
размягчать	размягчить
смягчать	смягчить
умягчать	умягчить
отягчать	отягчить
увековечивать	увековечить
очеловечивать	очеловечить
вочеловечивать	вочеловечить
изувечивать	изувечить
залечивать	залечить
перекалечивать	перекалечить
искалечивать	искалечить
подлечивать	подлечить
перелечивать	перелечить
излечивать	излечить
долечивать	долечить
недолечивать	недолечить
пролечивать	пролечить
вылечивать	вылечить
онемечивать	онемечить
обеспечивать	обеспечить
отуречивать	отуречить
обналичивать	обналичить
обличать	обличить
изобличать	изобличить
возвеличивать	возвеличить
увеличивать	увеличить
преувеличивать	преувеличить
различать	различить
обезличивать	обезличить
сличать	сличить
отличать	отличить
уличать	уличить
разграничивать	разграничить
ограничивать	ограничить
отграничивать	отграничить
ополчать	ополчить
кончать	кончить
заканчивать	закончить
приканчивать	прикончить
оканчивать	окончить
доканчивать	докончить
истончать	истончить
утончать	утончить
выклянчивать	выклянчить
вынянчивать	вынянчить
упорядочивать	упорядочить
всклокочивать	всклокочить
заскакивать	заскочить
наскакивать	наскочить
вскакивать	вскочить
привскакивать	привскочить
подскакивать	подскочить
перескакивать	перескочить
прискакивать	прискочить
доскакивать	доскочить
проскакивать	проскочить
соскакивать	соскочить
отскакивать	отскочить
выскакивать	выскочить
подщелачивать	подщелочить
выщелачивать	выщелочить
всклочивать	всклочить
наволакивать	наволочить
вволакивать	вволочить
подволакивать	подволочить
переволакивать	переволочить
взволакивать	взволочить
приволакивать	приволочить
доволакивать	доволочить
проволакивать	проволочить
сволакивать	сволочить
отволакивать	отволочить
отволакивать	отволочить
уволакивать	уволочить
выволакивать	выволочить
замачивать	замочить
намачивать	намочить
обмачивать	обмочить
надмачивать	надмочить
подмачивать	подмочить
перемачивать	перемочить
размачивать	размочить
взмачивать	взмочить
измачивать	измочить
примачивать	примочить
омачивать	омочить
уполномочивать	уполномочить
промачивать	промочить
смачивать	смочить
отмачивать	отмочить
вымачивать	вымочить
опорочивать	опорочить
заторачивать	заторочить
вторачивать	второчить
подторачивать	подторочить
переторачивать	переторочить
приторачивать	приторочить
оторачивать	оторочить
выторачивать	выторочить
упрочивать	упрочить
пересрочивать	пересрочить
просрочивать	просрочить
рассрочивать	рассрочить
отсрочивать	отсрочить
застрачивать	застрочить
настрачивать	настрочить
обстрачивать	обстрочить
подстрачивать	подстрочить
перестрачивать	перестрочить
пристрачивать	пристрочить
дострачивать	дострочить
прострачивать	прострочить
сострачивать	сострочить
исстрачивать	исстрочить
отстрачивать	отстрочить
выстрачивать	выстрочить
приурочивать	приурочить
подсачивать	подсочить
пропесочивать	пропесочить
высачивать	высочить
затачивать	заточить
заточать	заточить
натачивать	наточить
обтачивать	обточить
подтачивать	подточить
перетачивать	переточить
притачивать	приточить
дотачивать	доточить
сосредоточивать	сосредоточить
рассредоточивать	рассредоточить
протачивать	проточить
стачивать	сточить
растачивать	расточить
расточать	расточить
обесточивать	обесточить
ожесточать	ожесточить
ужесточать	ужесточить
истачивать	источить
источать	источить
оттачивать	отточить
утачивать	уточить
вытачивать	выточить
наперчивать	наперчить
наперчивать	наперчить
переперчивать	переперчить
переперчивать	переперчить
приперчивать	приперчить
приперчивать	приперчить
проперчивать	проперчить
проперчивать	проперчить
огорчать	огорчить
разогорчать	разогорчить
заучивать	заучить
научать	научить
забучивать	забучить
набучивать	набучить
обучать	обучить
переобучать	переобучить
нахлобучивать	нахлобучить
отбучивать	отбучить
отчубучивать	отчубучить
выбучивать	выбучить
обеззвучивать	обеззвучить
озвучивать	озвучить
переозвучивать	переозвучить
подучивать	подучить
переучивать	переучить
разучивать	разучить
изучать	изучить
приучать	приучить
окучивать	окучить
скучивать	скучить
наскучивать	наскучить
прискучивать	прискучить
залучать	залучить
облучать	облучить
разлучать	разлучить
излучать	излучить
прилучать	прилучить
получать	получить
заполучать	заполучить
дополучать	дополучить
недополучать	недополучить
случать	случить
отлучать	отлучить
улучать	улучить
замучивать	замучить
перемучивать	перемучить
размучивать	размучить
измучивать	измучить
домучивать	домучить
промучивать	промучить
отмучивать	отмучить
умучивать	умучить
вымучивать	вымучить
доучивать	доучить
недоучивать	недоучить
проучивать	проучить
напучивать	напучить
распучивать	распучить
вспучивать	вспучить
выпучивать	выпучить
обручать	обручить
вручать	вручить
удручать	удручить
приручать	приручить
поручать	поручить
перепоручать	перепоручить
препоручать	препоручить
выручать	выручить
засучивать	засучить
насучивать	насучить
всучивать	всучить
подсучивать	подсучить
пересучивать	пересучить
присучивать	присучить
ссучивать	ссучить
рассучивать	рассучить
отсучивать	отсучить
высучивать	высучить
улетучивать	улетучить
отучивать	отучить
замундштучивать	замундштучить
размундштучивать	размундштучить
прищучивать	прищучить
выучивать	выучить
закавычивать	закавычить
раскавычивать	раскавычить
размельчать	размельчить
измельчать	измельчить
умельчать	умельчить
заключать	заключить
перезаключать	перезаключить
умозаключать	умозаключить
включать	включить
подключать	подключить
переключать	переключить
приключать	приключить
исключать	исключить
отключать	отключить
выключать	выключить
выканючивать	выканючить
вздрючивать	вздрючить
скрючивать	скрючить
завьючивать	завьючить
навьючивать	навьючить
перевьючивать	перевьючить
развьючивать	развьючить
ополячивать	ополячить
разгорячать	разгорячить
раскорячивать	раскорячить
зашивать	зашить
нашивать	нашить
ошарашивать	ошарашить
устрашать	устрашить
обшивать	обшить
вшивать	вшить
надшивать	надшить
подшивать	подшить
ухудшать	ухудшить
обвешивать	обвешить
провешивать	провешить
вывешивать	вывешить
расклешивать	расклешить
спешивать	спешить
решать	решить
прегрешать	прегрешить
погрешать	погрешить
согрешать	согрешить
предрешать	предрешить
перешивать	перешить
перерешать	перерешить
разрешать	разрешить
отрешать	отрешить
потешать	потешить
утешать	утешить
лишать	лишить
пришивать	пришить
утишать	утишить
дошивать	дошить
облапошивать	облапошить
взъерошивать	взъерошить
накрашивать	накрошить
обкрашивать	обкрошить
подкрашивать	подкрошить
перекрашивать	перекрошить
докрашивать	докрошить
раскрашивать	раскрошить
искрашивать	искрошить
выкрашивать	выкрошить
переворашивать	переворошить
разворашивать	разворошить
огорошивать	огорошить
запорашивать	запорошить
припорашивать	припорошить
прошивать	прошить
опустошать	опустошить
завершать	завершить
подвершивать	подвершить
довершать	довершить
совершать	совершить
свершать	свершить
вывершивать	вывершить
сшивать	сшить
расшивать	расшить
исшивать	исшить
отшивать	отшить
ушивать	ушить
заушать	заушить
обездушивать	обездушить
удушать	удушить
заглушать	заглушить
приглушать	приглушить
оглушать	оглушить
вышелушивать	вышелушить
внушать	внушить
оглоушивать	оглоушить
подпушать	подпушить
опушать	опушить
распушать	распушить
нарушать	нарушить
обрушивать	обрушить
разрушать	разрушить
сокрушать	сокрушить
засушивать	засушить
насушивать	насушить
обсушивать	обсушить
подсушивать	подсушить
пересушивать	пересушить
присушивать	присушить
осушать	осушить
досушивать	досушить
просушивать	просушить
иссушать	иссушить
усушать	усушить
высушивать	высушить
утушать	утушить
улучшать	улучшить
вышивать	вышить
уменьшать	уменьшить
уменьшать	уменьшить
преуменьшать	преуменьшить
преуменьшать	преуменьшить
приуменьшать	приуменьшить
приуменьшать	приуменьшить
втемяшивать	втемяшить
вытаращивать	вытаращить
затаскивать	затащить
натаскивать	натащить
обтаскивать	обтащить
втаскивать	втащить
подтаскивать	подтащить
перетаскивать	перетащить
притаскивать	притащить
дотаскивать	дотащить
протаскивать	протащить
стаскивать	стащить
растаскивать	растащить
встаскивать	встащить
оттаскивать	оттащить
утаскивать	утащить
вытаскивать	вытащить
обобщать	обобщить
разобщать	разобщить
приобщать	приобщить
сообщать	сообщить
наващивать	навощить
подващивать	подвощить
проващивать	провощить
выващивать	вывощить
залащивать	залощить
вылащивать	вылощить
истощать	истощить
обмирщать	обмирщить
перебарщивать	переборщить
наморщивать	наморщить
сморщивать	сморщить
встопорщивать	встопорщить
налущивать	налущить
облущивать	облущить
подлущивать	подлущить
перелущивать	перелущить
взлущивать	взлущить
вылущивать	вылущить
приплющивать	приплющить
сплющивать	сплющить
расплющивать	расплющить
закалывать	заколоть
накалывать	наколоть
обкалывать	обколоть
вкалывать	вколоть
надкалывать	надколоть
подкалывать	подколоть
перекалывать	переколоть
прикалывать	приколоть
докалывать	доколоть
прокалывать	проколоть
скалывать	сколоть
раскалывать	расколоть
искалывать	исколоть
откалывать	отколоть
укалывать	уколоть
выкалывать	выколоть
намалывать	намолоть
обмалывать	обмолоть
подмалывать	подмолоть
перемалывать	перемолоть
размалывать	размолоть
измалывать	измолоть
прималывать	примолоть
домалывать	домолоть
промалывать	промолоть
смалывать	смолоть
отмалывать	отмолоть
вымалывать	вымолоть
перепалывать	переполоть
опалывать	ополоть
допалывать	дополоть
пропалывать	прополоть
спалывать	сполоть
выпалывать	выполоть
перебарывать	перебороть
запарывать	запороть
напарывать	напороть
надпарывать	надпороть
подпарывать	подпороть
перепарывать	перепороть
опарывать	опороть
допарывать	допороть
пропарывать	пропороть
спарывать	спороть
распарывать	распороть
вспарывать	вспороть
отпарывать	отпороть
выпарывать	выпороть
западать	запасть
нападать	напасть
нападать	напасть
впадать	впасть
совпадать	совпасть
подпадать	подпасть
перепадать	перепасть
припадать	припасть
опадать	опасть
попадать	попасть
пропадать	пропасть
запропадать	запропасть
спадать	спасть
ниспадать	ниспасть
отпадать	отпасть
выпадать	выпасть
накрадывать	накрасть
обкрадывать	обокрасть
скрадывать	скрасть
раскрадывать	раскрасть
выкрадывать	выкрасть
заедать	заесть
наедать	наесть
переедать	переесть
доедать	доесть
надоедать	надоесть
недоедать	недоесть
проедать	проесть
садиться	сесть
засаживаться	засесть
заседать	засесть
насаживаться	насесть
наседать	насесть
обседать	обсесть
подсаживаться	подсесть
пересаживаться	пересесть
присаживаться	присесть
приседать	присесть
оседать	осесть
проседать	просесть
восседать	воссесть
отсаживаться	отсесть
отседать	отсесть
уедать	уесть
зачитывать	зачесть
начитывать	начесть
перечитывать	перечесть
причитывать	причесть
дочитывать	дочесть
почитать	почесть
предпочитать	предпочесть
прочитывать	прочесть
считать	счесть
рассчитывать	расчесть
учитывать	учесть
переучитывать	переучесть
недоучитывать	недоучесть
вычитать	вычесть
объедать	объесть
надъедать	надъесть
подъедать	подъесть
разъедать	разъесть
изъедать	изъесть
съедать	съесть
отъедать	отъесть
выедать	выесть
заклинать	заклясть
проклинать	проклясть
напрядать	напрясть
впрядать	впрясть
припрядать	припрясть
допрядать	допрясть
отпрядать	отпрясть
выпрядать	выпрясть
обувать	обуть
переобувать	переобуть
задувать	задуть
надувать	надуть
обдувать	обдуть
вдувать	вдуть
поддувать	поддуть
передувать	передуть
раздувать	раздуть
вздувать	вздуть
продувать	продуть
сдувать	сдуть
отдувать	отдуть
выдувать	выдуть
разувать	разуть
обманывать	обмануть
захлебывать	захлебнуть
прихлебывать	прихлебнуть
схлебывать	схлебнуть
отхлебывать	отхлебнуть
ухлебывать	ухлебнуть
выхлебывать	выхлебнуть
погибать	погибнуть
вызябать	вызябнуть
выблевывать	выблевнуть
загибать	загнуть
нагибать	нагнуть
перешагивать	перешагнуть
дошагивать	дошагнуть
отшагивать	отшагнуть
вышагивать	вышагнуть
избегать	избегнуть
прибегать	прибегнуть
перегибать	перегнуть
застегивать	застегнуть
подстегивать	подстегнуть
перестегивать	перестегнуть
пристегивать	пристегнуть
состегивать	состегнуть
расстегивать	расстегнуть
отстегивать	отстегнуть
выстегивать	выстегнуть
взвизгивать	взвизгнуть
воздвигать	воздвигнуть
подмигивать	подмигнуть
пригибать	пригнуть
застигать	застигнуть
настигать	настигнуть
пристигать	пристигнуть
достигать	достигнуть
постигать	постигнуть
прилыгать	прилгнуть
огибать	обогнуть
вгибать	вогнуть
надгибать	надогнуть
подгибать	подогнуть
разгибать	разогнуть
изгибать	изогнуть
вздрагивать	вздрогнуть
прогибать	прогнуть
сгибать	согнуть
отгибать	отогнуть
ввергать	ввергнуть
подвергать	подвергнуть
извергать	извергнуть
низвергать	низвергнуть
повергать	повергнуть
опровергать	опровергнуть
ниспровергать	ниспровергнуть
свергать	свергнуть
отвергать	отвергнуть
подмаргивать	подморгнуть
расторгать	расторгнуть
исторгать	исторгнуть
отторгать	отторгнуть
подпугивать	подпугнуть
припугивать	припугнуть
спугивать	спугнуть
распугивать	распугнуть
вспугивать	вспугнуть
отпугивать	отпугнуть
выпугивать	выпугнуть
выгибать	выгнуть
прошмыгивать	прошмыгнуть
вышмыгивать	вышмыгнуть
изрыгать	изрыгнуть
запрыгивать	запрыгнуть
впрыгивать	впрыгнуть
подпрыгивать	подпрыгнуть
перепрыгивать	перепрыгнуть
припрыгивать	припрыгнуть
допрыгивать	допрыгнуть
спрыгивать	спрыгнуть
вспрыгивать	вспрыгнуть
отпрыгивать	отпрыгнуть
упрыгивать	упрыгнуть
выпрыгивать	выпрыгнуть
срыгивать	срыгнуть
отрыгивать	отрыгнуть
присягать	присягнуть
досягать	досягнуть
посягать	посягнуть
исчезать	исчезнуть
облизывать	облизнуть
слизывать	слизнуть
разверзать	разверзнуть
дерзать	дерзнуть
замерзать	замерзнуть
намерзать	намерзнуть
обмерзать	обмерзнуть
вмерзать	вмерзнуть
подмерзать	подмерзнуть
перемерзать	перемерзнуть
примерзать	примерзнуть
промерзать	промерзнуть
смерзать	смерзнуть
отмерзать	отмерзнуть
вымерзать	вымерзнуть
перебрызгивать	перебрызнуть
разбрызгивать	разбрызнуть
взбрызгивать	взбрызнуть
обрызгивать	обрызнуть
сбрызгивать	сбрызнуть
выбрызгивать	выбрызнуть
вскальзывать	вскользнуть
проскальзывать	проскользнуть
соскальзывать	соскользнуть
ускользать	ускользнуть
выскальзывать	выскользнуть
завязать	завязнуть
навязать	навязнуть
ввязать	ввязнуть
увязать	увязнуть
погрязать	погрязнуть
задвигать	задвинуть
надвигать	надвинуть
вдвигать	вдвинуть
передвигать	передвинуть
раздвигать	раздвинуть
придвигать	придвинуть
пододвигать	пододвинуть
подвигать	подвинуть
продвигать	продвинуть
содвигать	содвинуть
отодвигать	отодвинуть
сдвигать	сдвинуть
выдвигать	выдвинуть
разевать	разинуть
закидывать	закинуть
накидывать	накинуть
обкидывать	обкинуть
вкидывать	вкинуть
подкидывать	подкинуть
перекидывать	перекинуть
прикидывать	прикинуть
окидывать	окинуть
докидывать	докинуть
покидать	покинуть
прокидывать	прокинуть
запрокидывать	запрокинуть
опрокидывать	опрокинуть
выпрокидывать	выпрокинуть
скидывать	скинуть
раскидывать	раскинуть
вскидывать	вскинуть
откидывать	откинуть
выкидывать	выкинуть
поддакивать	поддакнуть
обмакивать	обмакнуть
намекать	намекнуть
смекать	смекнуть
попрекать	попрекнуть
упрекать	упрекнуть
подстрекать	подстрекнуть
перекликать	перекликнуть
окликать	окликнуть
восклицать	воскликнуть
выкликивать	выкликнуть
вникать	вникнуть
возникать	возникнуть
приникать	приникнуть
поникать	поникнуть
проникать	проникнуть
сникать	сникнуть
прикрикивать	прикрикнуть
окрикивать	окрикнуть
вскрикивать	вскрикнуть
выкрикивать	выкрикнуть
подхихикивать	подхихикнуть
защелкивать	защелкнуть
подщелкивать	подщелкнуть
подщелкивать	подщелкнуть
прищелкивать	прищелкнуть
расщелкивать	расщелкнуть
отщелкивать	отщелкнуть
выщелкивать	выщелкнуть
замолкать	замолкнуть
примолкать	примолкнуть
смолкать	смолкнуть
умолкать	умолкнуть
приумолкать	приумолкнуть
заталкивать	затолкнуть
наталкивать	натолкнуть
вталкивать	втолкнуть
подталкивать	подтолкнуть
переталкивать	перетолкнуть
приталкивать	притолкнуть
проталкивать	протолкнуть
сталкивать	столкнуть
расталкивать	растолкнуть
отталкивать	оттолкнуть
выталкивать	вытолкнуть
замыкать	замкнуть
перемыкать	перемкнуть
примыкать	примкнуть
размыкать	разомкнуть
смыкать	сомкнуть
отмыкать	отомкнуть
замокать	замокнуть
намокать	намокнуть
обмокать	обмокнуть
надмокать	надмокнуть
подмокать	подмокнуть
перемокать	перемокнуть
размокать	размокнуть
взмокать	взмокнуть
измокать	измокнуть
промокать	промокнуть
промокать	промокнуть
смокать	смокнуть
отмокать	отмокнуть
умокать	умокнуть
причмокивать	причмокнуть
вымокать	вымокнуть
отхаркивать	отхаркнуть
выхаркивать	выхаркнуть
подшаркивать	подшаркнуть
зачеркивать	зачеркнуть
подчеркивать	подчеркнуть
перечеркивать	перечеркнуть
очеркивать	очеркнуть
прочеркивать	прочеркнуть
расчеркивать	расчеркнуть
отчеркивать	отчеркнуть
вычеркивать	вычеркнуть
затыкать	заткнуть
натыкать	наткнуть
перетыкать	переткнуть
притыкать	приткнуть
втыкать	воткнуть
подтыкать	подоткнуть
протыкать	проткнуть
стыкать	соткнуть
оттыкать	ототкнуть
утыкать	уткнуть
пристукивать	пристукнуть
навыкать	навыкнуть
обвыкать	обвыкнуть
приобвыкать	приобвыкнуть
привыкать	привыкнуть
отвыкать	отвыкнуть
умыкать	умыкнуть
взбрыкивать	взбрыкнуть
намякать	намякнуть
обмякать	обмякнуть
подмякать	подмякнуть
размякать	размякнуть
смякать	смякнуть
отмякать	отмякнуть
умякать	умякнуть
подкрякивать	подкрякнуть
вскрякивать	вскрякнуть
иссякать	иссякнуть
затрагивать	затронуть
страгивать	стронуть
потопать	потонуть
утопать	утонуть
вкапывать	вкапнуть
подкапывать	подкапнуть
оцарапывать	оцарапнуть
сцарапывать	сцарапнуть
подцапывать	подцапнуть
сцапывать	сцапнуть
пришлепывать	пришлепнуть
подшептывать	подшепнуть
залипать	залипнуть
налипать	налипнуть
облипать	облипнуть
влипать	влипнуть
подлипать	подлипнуть
прилипать	прилипнуть
отлипать	отлипнуть
всхлипывать	всхлипнуть
защипывать	защипнуть
сощипывать	сощипнуть
отщипывать	отщипнуть
ущипывать	ущипнуть
выщипывать	выщипнуть
захлопывать	захлопнуть
нахлопывать	нахлопнуть
прихлопывать	прихлопнуть
пропинать	пропнуть
притопывать	притопнуть
зачерпывать	зачерпнуть
перечерпывать	перечерпнуть
дочерпывать	дочерпнуть
почерпать	почерпнуть
счерпывать	счерпнуть
отчерпывать	отчерпнуть
учерпывать	учерпнуть
вычерпывать	вычерпнуть
подколупывать	подколупнуть
сколупывать	сколупнуть
всколупывать	всколупнуть
отколупывать	отколупнуть
уколупывать	уколупнуть
выколупывать	выколупнуть
обертывать	обернуть
обертывать	обернуть
оборачивать	обернуть
оборачивать	обернуть
завертывать	завернуть
завертывать	завернуть
навертывать	навернуть
наворачивать	навернуть
обвертывать	обвернуть
ввертывать	ввернуть
надвертывать	надвернуть
подвертывать	подвернуть
подвертывать	подвернуть
перевертывать	перевернуть
развертывать	развернуть
привертывать	привернуть
довертывать	довернуть
недовертывать	недовернуть
поворачивать	повернуть
провертывать	провернуть
провертывать	провернуть
свертывать	свернуть
свертывать	свернуть
отвертывать	отвернуть
отворачивать	отвернуть
увертывать	увернуть
вывертывать	вывернуть
вывертывать	вывернуть
задергивать	задернуть
надергивать	надернуть
обдергивать	обдернуть
вдергивать	вдернуть
поддергивать	поддернуть
передергивать	передернуть
раздергивать	раздернуть
вздергивать	вздернуть
одергивать	одернуть
продергивать	продернуть
сдергивать	сдернуть
отдергивать	отдернуть
выдергивать	выдернуть
прихварывать	прихворнуть
подковыривать	подковырнуть
проковыривать	проковырнуть
сковыривать	сковырнуть
отковыривать	отковырнуть
выковыривать	выковырнуть
перекувыркивать	перекувырнуть
выкувыркивать	выкувырнуть
зашвыривать	зашвырнуть
подшвыривать	подшвырнуть
перешвыривать	перешвырнуть
дошвыривать	дошвырнуть
расшвыривать	расшвырнуть
отшвыривать	отшвырнуть
ушвыривать	ушвырнуть
вышвыривать	вышвырнуть
подныривать	поднырнуть
доныривать	донырнуть
проныривать	пронырнуть
уныривать	унырнуть
вышныривать	вышнырнуть
выныривать	вынырнуть
загасать	загаснуть
погасать	погаснуть
угасать	угаснуть
ужасать	ужаснуть
засыпать	заснуть
взблескивать	взблеснуть
проблескивать	проблеснуть
заплескивать	заплеснуть
вплескивать	вплеснуть
подплескивать	подплеснуть
переплескивать	переплеснуть
приплескивать	приплеснуть
оплескивать	оплеснуть
доплескивать	доплеснуть
сплескивать	сплеснуть
расплескивать	расплеснуть
всплескивать	всплеснуть
отплескивать	отплеснуть
выплескивать	выплеснуть
воскресать	воскреснуть
зависать	зависнуть
нависать	нависнуть
обвисать	обвиснуть
перевисать	перевиснуть
развисать	развиснуть
повисать	повиснуть
провисать	провиснуть
свисать	свиснуть
отвисать	отвиснуть
закисать	закиснуть
накисать	накиснуть
подкисать	подкиснуть
перекисать	перекиснуть
окисать	окиснуть
докисать	докиснуть
прокисать	прокиснуть
скисать	скиснуть
раскисать	раскиснуть
вскисать	вскиснуть
укисать	укиснуть
выкисать	выкиснуть
затискивать	затиснуть
обтискивать	обтиснуть
втискивать	втиснуть
подтискивать	подтиснуть
притискивать	притиснуть
протискивать	протиснуть
стискивать	стиснуть
растискивать	растиснуть
оттискивать	оттиснуть
вытиснять	вытиснуть
заполаскивать	заполоснуть
ополаскивать	ополоснуть
прополаскивать	прополоснуть
споласкивать	сполоснуть
всполаскивать	всполоснуть
выполаскивать	выполоснуть
впрыскивать	впрыснуть
перепрыскивать	перепрыснуть
опрыскивать	опрыснуть
спрыскивать	спрыснуть
вспрыскивать	вспрыснуть
выпрыскивать	выпрыснуть
приплющивать	приплюснуть
сплющивать	сплюснуть
расплющивать	расплюснуть
вметывать	вметнуть
подметывать	подметнуть
переметывать	переметнуть
взметывать	взметнуть
приметывать	приметнуть
дометывать	дометнуть
прометывать	прометнуть
выметывать	выметнуть
улепетывать	улепетнуть
взбалтывать	взболтнуть
сбалтывать	сболтнуть
выбалтывать	выболтнуть
сглатывать	сглотнуть
отглатывать	отглотнуть
прихвастывать	прихвастнуть
захлестывать	захлестнуть
нахлестывать	нахлестнуть
подхлестывать	подхлестнуть
перехлестывать	перехлестнуть
прихлестывать	прихлестнуть
схлестывать	схлестнуть
расхлестывать	расхлестнуть
ухлестывать	ухлестнуть
выхлестывать	выхлестнуть
присвистывать	присвистнуть
обдувать	обдунуть
вдувать	вдунуть
сдувать	сдунуть
окунать	окунуть
засовывать	засунуть
насовывать	насунуть
всовывать	всунуть
подсовывать	подсунуть
пересовывать	пересунуть
просовывать	просунуть
ссовывать	ссунуть
высовывать	высунуть
обмахивать	обмахнуть
подмахивать	подмахнуть
перемахивать	перемахнуть
размахивать	размахнуть
взмахивать	взмахнуть
домахивать	домахнуть
смахивать	смахнуть
отмахивать	отмахнуть
вымахивать	вымахнуть
запахивать	запахнуть
опахивать	опахнуть
пропахивать	пропахнуть
распахивать	распахнуть
отпахивать	отпахнуть
свихивать	свихнуть
вывихивать	вывихнуть
запихивать	запихнуть
впихивать	впихнуть
подпихивать	подпихнуть
перепихивать	перепихнуть
припихивать	припихнуть
пропихивать	пропихнуть
спихивать	спихнуть
распихивать	распихнуть
отпихивать	отпихнуть
упихивать	упихнуть
выпихивать	выпихнуть
затихать	затихнуть
перетихать	перетихнуть
притихать	притихнуть
стихать	стихнуть
утихать	утихнуть
приутихать	приутихнуть
вычихивать	вычихнуть
вдыхать	вдохнуть
передыхать	передохнуть
вздыхать	вздохнуть
издыхать	издохнуть
воздыхать	воздохнуть
подыхать	подохнуть
продыхать	продохнуть
сдыхать	сдохнуть
отдыхать	отдохнуть
выдыхать	выдохнуть
засыхать	засохнуть
насыхать	насохнуть
обсыхать	обсохнуть
подсыхать	подсохнуть
пересыхать	пересохнуть
присыхать	присохнуть
досыхать	досохнуть
просыхать	просохнуть
иссыхать	иссохнуть
отсыхать	отсохнуть
усыхать	усохнуть
высыхать	высохнуть
запархивать	запорхнуть
впархивать	впорхнуть
перепархивать	перепорхнуть
припархивать	припорхнуть
пропархивать	пропорхнуть
спархивать	спорхнуть
вспархивать	вспорхнуть
отпархивать	отпорхнуть
упархивать	упорхнуть
выпархивать	выпорхнуть
забухать	забухнуть
набухать	набухнуть
вбухивать	вбухнуть
разбухать	разбухнуть
взбухать	взбухнуть
выбухивать	выбухнуть
запухать	запухнуть
напухать	напухнуть
подпухать	подпухнуть
припухать	припухнуть
опухать	опухнуть
распухать	распухнуть
вспухать	вспухнуть
затухать	затухнуть
притухать	притухнуть
потухать	потухнуть
протухать	протухнуть
всколыхивать	всколыхнуть
вспыхивать	вспыхнуть
обтряхивать	обтряхнуть
перетряхивать	перетряхнуть
отряхивать	отряхнуть
протряхивать	протряхнуть
стряхивать	стряхнуть
растряхивать	растряхнуть
встряхивать	встряхнуть
оттряхивать	оттряхнуть
вытряхивать	вытряхнуть
вынимать	вынуть
застывать	застынуть
настывать	настынуть
подстывать	подстынуть
перестывать	перестынуть
пристывать	пристынуть
остывать	остынуть
приостывать	приостынуть
простывать	простынуть
свиливать	свильнуть
отвиливать	отвильнуть
увиливать	увильнуть
проклевывать	проклюнуть
склевывать	склюнуть
выклевывать	выклюнуть
переплевывать	переплюнуть
доплевывать	доплюнуть
сплевывать	сплюнуть
отплевывать	отплюнуть
выплевывать	выплюнуть
увядать	увянуть
заглядывать	заглянуть
взглядывать	взглянуть
оглядывать	оглянуть
проглядывать	проглянуть
выглядывать	выглянуть
подкашливать	подкашлянуть
прокашливать	прокашлянуть
откашливать	откашлянуть
выкашливать	выкашлянуть
поминать	помянуть
вспоминать	вспомянуть
упоминать	упомянуть
отпрядывать	отпрянуть
затягивать	затянуть
натягивать	натянуть
обтягивать	обтянуть
втягивать	втянуть
подтягивать	подтянуть
перетягивать	перетянуть
притягивать	притянуть
дотягивать	дотянуть
недотягивать	недотянуть
протягивать	протянуть
стягивать	стянуть
растягивать	растянуть
оттягивать	оттянуть
утягивать	утянуть
вытягивать	вытянуть
забывать	забыть
подзабывать	подзабыть
позабывать	позабыть
избывать	избыть
прибывать	прибыть
добывать	добыть
раздобывать	раздобыть
сбывать	сбыть
отбывать	отбыть
убывать	убыть
выбывать	выбыть
подвывать	подвыть
взвывать	взвыть
заплывать	заплыть
наплывать	наплыть
вплывать	вплыть
подплывать	подплыть
переплывать	переплыть
приплывать	приплыть
оплывать	оплыть
оплывать	оплыть
доплывать	доплыть
проплывать	проплыть
сплывать	сплыть
всплывать	всплыть
отплывать	отплыть
уплывать	уплыть
выплывать	выплыть
прослывать	прослыть
замывать	замыть
намывать	намыть
обмывать	обмыть
подмывать	подмыть
перемывать	перемыть
размывать	размыть
взмывать	взмыть
омывать	омыть
домывать	домыть
промывать	промыть
смывать	смыть
отмывать	отмыть
умывать	умыть
вымывать	вымыть
изнывать	изныть
зарывать	зарыть
нарывать	нарыть
обрывать	обрыть
врывать	врыть
подрывать	подрыть
перерывать	перерыть
разрывать	разрыть
взрывать	взрыть
изрывать	изрыть
закрывать	закрыть
накрывать	накрыть
перекрывать	перекрыть
прикрывать	прикрыть
докрывать	докрыть
покрывать	покрыть
прокрывать	прокрыть
скрывать	скрыть
раскрывать	раскрыть
вскрывать	вскрыть
открывать	открыть
приоткрывать	приоткрыть
укрывать	укрыть
выкрывать	выкрыть
дорывать	дорыть
прорывать	прорыть
срывать	срыть
отрывать	отрыть
вырывать	вырыть
застывать	застыть
настывать	настыть
подстывать	подстыть
перестывать	перестыть
пристывать	пристыть
остывать	остыть
приостывать	приостыть
простывать	простыть
выстывать	выстыть
облаивать	облаять
размаивать	размаять
смаивать	смаять
умаивать	умаять
запаивать	запаять
напаивать	напаять
впаивать	впаять
подпаивать	подпаять
перепаивать	перепаять
припаивать	припаять
опаивать	опаять
допаивать	допаять
пропаивать	пропаять
спаивать	спаять
распаивать	распаять
отпаивать	отпаять
упаивать	упаять
выпаивать	выпаять
натаивать	натаять
обтаивать	обтаять
подтаивать	подтаять
дотаивать	дотаять
протаивать	протаять
стаивать	стаять
растаивать	растаять
истаивать	истаять
оттаивать	оттаять
вытаивать	вытаять
захаивать	захаять
обхаивать	обхаять
охаивать	охаять
расхаивать	расхаять
завевать	завеять
навеивать	навеять
навевать	навеять
обвеивать	обвеять
обвевать	обвеять
подвеивать	подвеять
перевеивать	перевеять
развеивать	развеять
взвевать	взвеять
овевать	овеять
довеивать	довеять
провеивать	провеять
свевать	свеять
отвеивать	отвеять
отвевать	отвеять
вывеивать	вывеять
засмеивать	засмеять
обсмеивать	обсмеять
пересмеивать	пересмеять
осмеивать	осмеять
просмеивать	просмеять
высмеивать	высмеять
засевать	засеять
насевать	насеять
обсевать	обсеять
всевать	всеять
подсевать	подсеять
пересевать	пересеять
присевать	присеять
досевать	досеять
просеивать	просеять
рассевать	рассеять
рассеивать	рассеять
отсеивать	отсеять
отсеивать	отсеять
усеивать	усеять
высевать	высеять
затевать	затеять
наваливать	навалять
обваливать	обвалять
переваливать	перевалять
разваливать	развалять
уваливать	увалять
вываливать	вывалять
настреливать	настрелять
обстреливать	обстрелять
пристреливать	пристрелять
достреливать	дострелять
простреливать	прострелять
расстреливать	расстрелять
исстреливать	исстрелять
отстреливать	отстрелять
выстреливать	выстрелять
загуливать	загулять
нагуливать	нагулять
подгуливать	подгулять
перегуливать	перегулять
разгуливать	разгулять
пригуливать	пригулять
догуливать	догулять
прогуливать	прогулять
отгуливать	отгулять
выгуливать	выгулять
прокашливать	прокашлять
откашливать	откашлять
выкашливать	выкашлять
заминать	замять
наминать	намять
обминать	обмять
вминать	вмять
подминать	подмять
переминать	перемять
разминать	размять
изминать	измять
приминать	примять
доминать	домять
проминать	промять
сминать	смять
отминать	отмять
уминать	умять
выминать	вымять
занимать	занять
перезанимать	перезанять
призанимать	призанять
нанимать	нанять
поднанимать	поднанять
принанимать	принанять
обнимать	обнять
внимать	внять
подравнивать	подравнять
приравнивать	приравнять
сравнивать	сравнять
уравнивать	уравнять
заравнивать	заровнять
обравнивать	обровнять
подравнивать	подровнять
разравнивать	разровнять
приравнивать	прировнять
сравнивать	сровнять
уравнивать	уровнять
выравнивать	выровнять
ободневать	ободнять
поднимать	поднять
приподнимать	приподнять
наменивать	наменять
обменивать	обменять
разменивать	разменять
променивать	променять
выменивать	выменять
перенимать	перенять
разнимать	разнять
принимать	принять
предпринимать	предпринять
воспринимать	воспринять
наганивать	нагонять
донимать	донять
понимать	понять
недопонимать	недопонять
пронимать	пронять
снимать	снять
заснимать	заснять
переснимать	переснять
отнимать	отнять
унимать	унять
настаивать	настоять
настаивать	настоять
перестаивать	перестоять
достаивать	достоять
простаивать	простоять
отстаивать	отстоять
отстаивать	отстоять
устаивать	устоять
выстаивать	выстоять
пропинать	пропять
распинать	распять
затеривать	затерять
растеривать	растерять
застревать	застрять
встревать	встрять
наковыривать	наковырять
обковыривать	обковырять
подковыривать	подковырять
перековыривать	перековырять
проковыривать	проковырять
сковыривать	сковырять
расковыривать	расковырять
исковыривать	исковырять
отковыривать	отковырять
выковыривать	выковырять
зашвыривать	зашвырять
нашвыривать	нашвырять
подшвыривать	подшвырять
дошвыривать	дошвырять
расшвыривать	расшвырять
отшвыривать	отшвырять
вышвыривать	вышвырять
обшныривать	обшнырять
вышныривать	вышнырять
учуивать	учуять
изымать	изъять
зажигать	зажечь
нажигать	нажечь
обжигать	обжечь
поджигать	поджечь
пережигать	пережечь
разжигать	разжечь
изжигать	изжечь
возжигать	возжечь
прижигать	прижечь
ожигать	ожечь
дожигать	дожечь
прожигать	прожечь
сжигать	сжечь
отжигать	отжечь
выжигать	выжечь
ложиться	лечь
залегать	залечь
налегать	налечь
подналегать	подналечь
приналегать	приналечь
облекать	облечь
облегать	облечь
завлекать	завлечь
навлекать	навлечь
развлекать	развлечь
извлекать	извлечь
привлекать	привлечь
вовлекать	вовлечь
совлекать	совлечь
отвлекать	отвлечь
увлекать	увлечь
подлегать	подлечь
возлегать	возлечь
прилегать	прилечь
полегать	полечь
пролегать	пролечь
слегать	слечь
отлегать	отлечь
запекать	запечь
напекать	напечь
впекать	впечь
подпекать	подпечь
перепекать	перепечь
припекать	припечь
допекать	допечь
недопекать	недопечь
пропекать	пропечь
распекать	распечь
отпекать	отпечь
упекать	упечь
выпекать	выпечь
нарекать	наречь
пренебрегать	пренебречь
обрекать	обречь
предрекать	предречь
заберегать	заберечь
приберегать	приберечь
оберегать	оберечь
сберегать	сберечь
уберегать	уберечь
подстерегать	подстеречь
остерегать	остеречь
предостерегать	предостеречь
устерегать	устеречь
изрекать	изречь
прорекать	проречь
засекать	засечь
засекать	засечь
насекать	насечь
обсекать	обсечь
надсекать	надсечь
подсекать	подсечь
пересекать	пересечь
пресекать	пресечь
осекать	осечь
просекать	просечь
ссекать	ссечь
рассекать	рассечь
иссекать	иссечь
отсекать	отсечь
усекать	усечь
высекать	высечь
затекать	затечь
натекать	натечь
обтекать	обтечь
втекать	втечь
подтекать	подтечь
перетекать	перетечь
притекать	притечь
отекать	отечь
дотекать	дотечь
протекать	протечь
стекать	стечь
истекать	истечь
истекать	истечь
проистекать	проистечь
оттекать	оттечь
утекать	утечь
вытекать	вытечь
застригать	застричь
настригать	настричь
обстригать	обстричь
подстригать	подстричь
перестригать	перестричь
остригать	остричь
достригать	достричь
постригать	постричь
простригать	простричь
состригать	состричь
расстригать	расстричь
отстригать	отстричь
выстригать	выстричь
застигать	застичь
настигать	настичь
пристигать	пристичь
достигать	достичь
постигать	постичь
заволакивать	заволочь
наволакивать	наволочь
наволакивать	наволочь
обволакивать	обволочь
вволакивать	вволочь
подволакивать	подволочь
переволакивать	переволочь
разволакивать	разволочь
взволакивать	взволочь
приволакивать	приволочь
доволакивать	доволочь
проволакивать	проволочь
сволакивать	сволочь
отволакивать	отволочь
уволакивать	уволочь
выволакивать	выволочь
занемогать	занемочь
изнемогать	изнемочь
перемогать	перемочь
превозмогать	превозмочь
помогать	помочь
запрягать	запрячь
перезапрягать	перезапрячь
напрягать	напрячь
перенапрягать	перенапрячь
впрягать	впрячь
подпрягать	подпрячь
перепрягать	перепрячь
припрягать	припрячь
сопрягать	сопрячь
спрягать	спрячь
распрягать	распрячь
отпрягать	отпрячь
упрягать	упрячь
выпрягать	выпрячь
расхлябываться	расхлябаться
перемежевываться	перемежеваться
размежевываться	размежеваться
отмежевываться	отмежеваться
вымежевываться	вымежеваться
разжевываться	разжеваться
прожевываться	прожеваться
зазевываться	зазеваться
размалевываться	размалеваться
облевываться	облеваться
выблевываться	выблеваться
зашпаклевываться	зашпаклеваться
расплевываться	расплеваться
отплевываться	отплеваться
довоевываться	довоеваться
зарубцовываться	зарубцеваться
вытанцовываться	вытанцеваться
затушевываться	затушеваться
стушевываться	стушеваться
называться	назваться
прозываться	прозваться
отзываться	отозваться
вызываться	вызваться
утрамбовываться	утрамбоваться
завербовываться	завербоваться
заинтриговываться	заинтриговаться
приторговываться	приторговаться
проторговываться	проторговаться
сторговываться	сторговаться
расторговываться	расторговаться
*	исповедоваться
отрекомендовываться	отрекомендоваться
*	образоваться
*	преобразоваться
*	сообразоваться
*	реализоваться
закристаллизовываться	закристаллизоваться
выкристаллизовываться	выкристаллизоваться
*	организоваться
*	реорганизоваться
переорганизовываться	переорганизоваться
*	дезорганизоваться
сорганизовываться	сорганизоваться
наэлектризовываться	наэлектризоваться
запаковываться	запаковаться
распаковываться	распаковаться
упаковываться	упаковаться
подковываться	подковаться
перековываться	перековаться
столковываться	столковаться
запарковываться	запарковаться
припарковываться	припарковаться
разворковываться	разворковаться
сковываться	сковаться
расковываться	расковаться
отковываться	отковаться
отпочковываться	отпочковаться
выковываться	выковаться
состыковываться	состыковаться
расстыковываться	расстыковаться
отстыковываться	отстыковаться
избаловываться	избаловаться
расцеловываться	расцеловаться
отформовываться	отформоваться
переэкзаменовываться	переэкзаменоваться
ознаменовываться	ознаменоваться
основываться	основаться
обосновываться	обосноваться
очаровываться	очароваться
разочаровываться	разочароваться
прикомандировываться	прикомандироваться
откомандировываться	откомандироваться
обмундировываться	обмундироваться
замаскировываться	замаскироваться
обмеблировываться	обмеблироваться
омеблировываться	омеблироваться
отполировываться	отполироваться
загримировываться	загримироваться
нагримировываться	нагримироваться
подгримировываться	подгримироваться
разгримировываться	разгримироваться
переформировываться	переформироваться
сформировываться	сформироваться
расформировываться	расформироваться
задрапировываться	задрапироваться
перегруппировываться	перегруппироваться
разгруппировываться	разгруппироваться
перебаллотировываться	перебаллотироваться
расквартировываться	расквартироваться
проворовываться	провороваться
профильтровываться	профильтроваться
замуровываться	замуроваться
зашнуровываться	зашнуроваться
перешнуровываться	перешнуроваться
расшнуровываться	расшнуроваться
стасовываться	стасоваться
заинтересовываться	заинтересоваться
обрисовываться	обрисоваться
изрисовываться	изрисоваться
прорисовываться	прорисоваться
вырисовываться	вырисоваться
запрессовываться	запрессоваться
спрессовываться	спрессоваться
законтрактовываться	законтрактоваться
укомплектовываться	укомплектоваться
доукомплектовываться	доукомплектоваться
забинтовываться	забинтоваться
перебинтовываться	перебинтоваться
разбинтовываться	разбинтоваться
зашвартовываться	зашвартоваться
пришвартовываться	пришвартоваться
отшвартовываться	отшвартоваться
наспиртовываться	наспиртоваться
проспиртовываться	проспиртоваться
напластовываться	напластоваться
отшлифовываться	отшлифоваться
застраховываться	застраховаться
подстраховываться	подстраховаться
перестраховываться	перестраховаться
зарываться	зарваться
нарываться	нарваться
перерываться	перерваться
прерываться	прерваться
обрываться	оборваться
врываться	ворваться
дорываться	дорваться
надрываться	надорваться
подрываться	подорваться
разрываться	разорваться
взрываться	взорваться
изрываться	изорваться
порываться	порваться
прорываться	прорваться
срываться	сорваться
отрываться	оторваться
урываться	урваться
вырываться	вырваться
замызгиваться	замызгаться
обмызгиваться	обмызгаться
измызгиваться	измызгаться
забрызгиваться	забрызгаться
разбрызгиваться	разбрызгаться
обрызгиваться	обрызгаться
задрызгиваться	задрызгаться
надрызгиваться	надрызгаться
сострагиваться	сострогаться
исстрагиваться	исстрогаться
издергиваться	издергаться
состругиваться	состругаться
исстругиваться	исстругаться
даваться	даться
догадываться	догадаться
задаваться	задаться
обдаваться	обдаться
вдаваться	вдаться
оправдываться	оправдаться
поддаваться	поддаться
наведываться	наведаться
переведываться	переведаться
разведываться	разведаться
доведываться	доведаться
исповедоваться	исповедаться
передаваться	передаться
предаваться	предаться
загваздываться	загваздаться
раздаваться	раздаться
воздаваться	воздаться
создаваться	создаться
воссоздаваться	воссоздаться
разнуздываться	разнуздаться
подаваться	податься
продаваться	продаться
запродаваться	запродаться
сдаваться	сдаться
засдаваться	засдаться
отдаваться	отдаться
удаваться	удаться
выдаваться	выдаться
зажиматься	зажаться
обжиматься	обжаться
обжинаться	обжаться
вжиматься	вжаться
поджиматься	поджаться
разбегаться	разбежаться
сбегаться	сбежаться
залеживаться	залежаться
облеживаться	облежаться
разлеживаться	разлежаться
долеживаться	долежаться
слеживаться	слежаться
отлеживаться	отлежаться
вылеживаться	вылежаться
разжиматься	разжаться
прижиматься	прижаться
пожиматься	пожаться
прожиматься	прожаться
задерживаться	задержаться
издерживаться	издержаться
воздерживаться	воздержаться
додерживаться	додержаться
сдерживаться	сдержаться
удерживаться	удержаться
выдерживаться	выдержаться
сжиматься	сжаться
отжиматься	отжаться
ужиматься	ужаться
выжиматься	выжаться
оказываться	оказаться
показываться	показаться
сказываться	сказаться
высказываться	высказаться
отказываться	отказаться
замазываться	замазаться
намазываться	намазаться
обмазываться	обмазаться
вмазываться	вмазаться
подмазываться	подмазаться
перемазываться	перемазаться
размазываться	размазаться
измазываться	измазаться
примазываться	примазаться
помазываться	помазаться
смазываться	смазаться
умазываться	умазаться
вымазываться	вымазаться
нарезаться	нарезаться
обрезаться	обрезаться
врезаться	врезаться
перерезаться	перерезаться
разрезаться	разрезаться
изрезаться	изрезаться
прорезаться	прорезаться
срезаться	срезаться
вырезаться	вырезаться
нализываться	нализаться
облизываться	облизаться
подлизываться	подлизаться
прилизываться	прилизаться
вылизываться	вылизаться
разнизываться	разнизаться
изнизываться	изнизаться
обязываться	обязаться
завязываться	завязаться
навязываться	навязаться
обвязываться	обвязаться
ввязываться	ввязаться
подвязываться	подвязаться
перевязываться	перевязаться
развязываться	развязаться
привязываться	привязаться
повязываться	повязаться
связываться	связаться
отвязываться	отвязаться
увязываться	увязаться
выплакиваться	выплакаться
вкарабкиваться	вкарабкаться
вскарабкиваться	вскарабкаться
выкарабкиваться	выкарабкаться
докликаться	докликаться
вталкиваться	втолкаться
проталкиваться	протолкаться
скомкиваться	скомкаться
отхаркиваться	отхаркаться
обшаркиваться	обшаркаться
расшаркиваться	расшаркаться
исшаркиваться	исшаркаться
затаскиваться	затаскаться
истаскиваться	истаскаться
наплескиваться	наплескаться
расплескиваться	расплескаться
выплескиваться	выплескаться
растрескиваться	растрескаться
приискиваться	приискаться
доискиваться	доискаться
втискиваться	втискаться
подтискиваться	подтискаться
притискиваться	притискаться
протискиваться	протискаться
оттискиваться	оттискаться
утискиваться	утискаться
выискиваться	выискаться
отполаскиваться	отполоскаться
разыскиваться	разыскаться
взыскиваться	взыскаться
изыскиваться	изыскаться
опрыскиваться	опрыскаться
сыскиваться	сыскаться
отыскиваться	отыскаться
размыкиваться	размыкаться
заделываться	заделаться
обделываться	обделаться
подделываться	подделаться
переделываться	переделаться
разделываться	разделаться
приделываться	приделаться
отделываться	отделаться
посылаться	послаться
ссылаться	сослаться
застилаться	застлаться
расстилаться	разостлаться
постилаться	постлаться
устилаться	устлаться
обламываться	обломаться
разламываться	разломаться
изламываться	изломаться
доламываться	доломаться
проламываться	проломаться
отламываться	отломаться
выламываться	выломаться
задумываться	задуматься
призадумываться	призадуматься
вдумываться	вдуматься
раздумываться	раздуматься
одумываться	одуматься
додумываться	додуматься
разгоняться	разогнаться
распеленываться	распеленаться
зазнаваться	зазнаться
признаваться	признаться
обознаваться	обознаться
дознаваться	дознаться
спознаваться	спознаться
сознаваться	сознаться
узнаваться	узнаться
закапываться	закапаться
обкапываться	обкапаться
окапываться	окапаться
укапываться	укапаться
расцарапываться	расцарапаться
исцарапываться	исцарапаться
выцарапываться	выцарапаться
вклепываться	вклепаться
приклепываться	приклепаться
склепываться	склепаться
расклепываться	расклепаться
отклепываться	отклепаться
затрепываться	затрепаться
обтрепываться	обтрепаться
растрепываться	растрепаться
истрепываться	истрепаться
оттрепываться	оттрепаться
общипываться	общипаться
закапываться	закопаться
вкапываться	вкопаться
подкапываться	подкопаться
окапываться	окопаться
докапываться	докопаться
прокапываться	прокопаться
откапываться	откопаться
выкапываться	выкопаться
влопываться	влопаться
обшарпываться	обшарпаться
исчерпываться	исчерпаться
просыпаться	проспаться
отсыпаться	отоспаться
высыпаться	выспаться
ощупываться	ощупаться
прощупываться	прощупаться
засыпаться	засыпаться
насыпаться	насыпаться
обсыпаться	обсыпаться
подсыпаться	подсыпаться
пересыпаться	пересыпаться
осыпаться	осыпаться
досыпаться	досыпаться
посыпаться	посыпаться
просыпаться	просыпаться
ссыпаться	ссыпаться
рассыпаться	рассыпаться
отсыпаться	отсыпаться
усыпаться	усыпаться
высыпаться	высыпаться
заляпываться	заляпаться
обляпываться	обляпаться
вляпываться	вляпаться
втяпываться	втяпаться
замарываться	замараться
обмарываться	обмараться
перемарываться	перемараться
измарываться	измараться
вымарываться	вымараться
забираться	забраться
набираться	набраться
поднабираться	поднабраться
перебираться	перебраться
прибираться	прибраться
вбираться	вобраться
добираться	добраться
подбираться	подобраться
разбираться	разобраться
взбираться	взобраться
пробираться	пробраться
собираться	собраться
убираться	убраться
разубираться	разубраться
выбираться	выбраться
завираться	завраться
довираться	довраться
развираться	разовраться
провираться	провраться
отвираться	отовраться
заигрываться	заиграться
доигрываться	доиграться
проигрываться	проиграться
выигрываться	выиграться
подыгрываться	подыграться
разыгрываться	разыграться
сыгрываться	сыграться
отыгрываться	отыграться
задираться	задраться
надираться	надраться
придираться	придраться
обдираться	ободраться
раздираться	разодраться
издираться	изодраться
продираться	продраться
сдираться	содраться
отдираться	отодраться
выдираться	выдраться
нажираться	нажраться
обжираться	обожраться
прожираться	прожраться
ужираться	ужраться
простирываться	простираться
состирываться	состираться
исстирываться	исстираться
отстирываться	отстираться
расхварываться	расхвораться
затесываться	затесаться
обтесываться	обтесаться
втесываться	втесаться
отесываться	отесаться
стесываться	стесаться
растесываться	растесаться
зачесываться	зачесаться
начесываться	начесаться
обчесываться	обчесаться
перечесываться	перечесаться
причесываться	причесаться
дочесываться	дочесаться
счесываться	счесаться
расчесываться	расчесаться
отчесываться	отчесаться
учесываться	учесаться
вычесываться	вычесаться
записываться	записаться
вписываться	вписаться
подписываться	подписаться
приписываться	приписаться
описываться	описаться
дописываться	дописаться
прописываться	прописаться
списываться	списаться
расписываться	расписаться
исписываться	исписаться
отписываться	отписаться
уписываться	уписаться
выписываться	выписаться
разбрасываться	разбросаться
насасываться	насосаться
всасываться	всосаться
подсасываться	подсосаться
присасываться	присосаться
досасываться	дососаться
просасываться	прососаться
рассасываться	рассосаться
доплясываться	доплясаться
подпоясываться	подпоясаться
перепоясываться	перепоясаться
препоясываться	препоясаться
опоясываться	опоясаться
распоясываться	распоясаться
присватываться	присвататься
нахватываться	нахвататься
обкатываться	обкататься
прикатываться	прикататься
докатываться	докататься
прокатываться	прокататься
скатываться	скататься
раскатываться	раскататься
укатываться	укататься
выкатываться	выкататься
запечатываться	запечататься
опечатываться	опечататься
распечатываться	распечататься
отпечатываться	отпечататься
упечатываться	упечататься
расшатываться	расшататься
разметываться	разметаться
выметываться	выметаться
сквитываться	сквитаться
расквитываться	расквитаться
отквитываться	отквитаться
напитываться	напитаться
впитываться	впитаться
пропитываться	пропитаться
воспитываться	воспитаться
перевоспитываться	перевоспитаться
зачитываться	зачитаться
начитываться	начитаться
вчитываться	вчитаться
дочитываться	дочитаться
обсчитываться	обсчитаться
досчитываться	досчитаться
недосчитываться	недосчитаться
просчитываться	просчитаться
сосчитываться	сосчитаться
рассчитываться	рассчитаться
рассчитываться	рассчитаться
отчитываться	отчитаться
забалтываться	заболтаться
перебалтываться	переболтаться
разбалтываться	разболтаться
взбалтываться	взболтаться
добалтываться	доболтаться
пробалтываться	проболтаться
выбалтываться	выболтаться
зарабатываться	заработаться
обрабатываться	обработаться
врабатываться	вработаться
подрабатываться	подработаться
перерабатываться	переработаться
разрабатываться	разработаться
прирабатываться	приработаться
дорабатываться	доработаться
срабатываться	сработаться
отрабатываться	отработаться
вырабатываться	выработаться
заматываться	замотаться
наматываться	намотаться
обматываться	обмотаться
разматываться	размотаться
изматываться	измотаться
доматываться	домотаться
проматываться	промотаться
сматываться	смотаться
отматываться	отмотаться
уматываться	умотаться
выматываться	вымотаться
притаптываться	притоптаться
протаптываться	протоптаться
стаптываться	стоптаться
растаптываться	растоптаться
истаптываться	истоптаться
утаптываться	утоптаться
распластываться	распластаться
нахлестываться	нахлестаться
расхлестываться	расхлестаться
исхлестываться	исхлестаться
отхлестываться	отхлестаться
ухлестываться	ухлестаться
выхлестываться	выхлестаться
оставаться	остаться
доставаться	достаться
опрастываться	опростаться
выпрастываться	выпростаться
сверстываться	сверстаться
уверстываться	уверстаться
расставаться	расстаться
закутываться	закутаться
накутываться	накутаться
обкутываться	обкутаться
окутываться	окутаться
раскутываться	раскутаться
укутываться	укутаться
запутываться	запутаться
впутываться	впутаться
перепутываться	перепутаться
припутываться	припутаться
спутываться	спутаться
распутываться	распутаться
отпутываться	отпутаться
выпутываться	выпутаться
допытываться	допытаться
запрятываться	запрятаться
перепрятываться	перепрятаться
упрятываться	упрятаться
выпахиваться	выпахаться
проезжаться	проехаться
отбрехиваться	отбрехаться
разъезжаться	разъехаться
съезжаться	съехаться
напихиваться	напихаться
впихиваться	впихаться
пропихиваться	пропихаться
вбухиваться	вбухаться
расколыхиваться	расколыхаться
всколыхиваться	всколыхаться
обнюхиваться	обнюхаться
внюхиваться	внюхаться
перенюхиваться	перенюхаться
принюхиваться	принюхаться
донюхиваться	донюхаться
снюхиваться	снюхаться
зачинаться	зачаться
накачиваться	накачаться
подкачиваться	подкачаться
раскачиваться	раскачаться
укачиваться	укачаться
начинаться	начаться
утачиваться	утачаться
отмалчиваться	отмолчаться
развенчиваться	развенчаться
увенчиваться	увенчаться
завешиваться	завешаться
обвешиваться	обвешаться
увешиваться	увешаться
замешиваться	замешаться
вмешиваться	вмешаться
перемешиваться	перемешаться
размешиваться	размешаться
примешиваться	примешаться
промешиваться	промешаться
смешиваться	смешаться
заслушиваться	заслушаться
вслушиваться	вслушаться
прислушиваться	прислушаться
ослушиваться	ослушаться
заговляться	заговеться
разговляться	разговеться
деваться	деться
надеваться	надеться
вдеваться	вдеться
раздеваться	раздеться
обижаться	обидеться
засиживаться	засидеться
обсиживаться	обсидеться
досиживаться	досидеться
рассиживаться	рассидеться
отсиживаться	отсидеться
высиживаться	высидеться
одеваться	одеться
переодеваться	переодеться
разодеваться	разодеться
продеваться	продеться
заглядываться	заглядеться
обглядываться	обглядеться
вглядываться	вглядеться
приглядываться	приглядеться
оглядываться	оглядеться
разбаливаться	разболеться
запечатлеваться	запечатлеться
отпечатлеваться	отпечатлеться
скипаться	скипеться
спеваться	спеться
распеваться	распеться
нагреваться	нагреться
перегреваться	перегреться
обогреваться	обогреться
подогреваться	подогреться
разогреваться	разогреться
прогреваться	прогреться
согреваться	согреться
отогреваться	отогреться
угреваться	угреться
запираться	запереться
запираться	запереться
впираться	впереться
подпираться	подпереться
припираться	припереться
опираться	опереться
опираться	опереться
пропираться	пропереться
спираться	спереться
отпираться	отпереться
отпираться	отпереться
упираться	упереться
затираться	затереться
натираться	натереться
обтираться	обтереться
втираться	втереться
подтираться	подтереться
перетираться	перетереться
притираться	притереться
отираться	отереться
протираться	протереться
стираться	стереться
растираться	растереться
истираться	истереться
простираться	простереться
распростираться	распростереться
оттираться	оттереться
утираться	утереться
вытираться	вытереться
загораться	загореться
разгораться	разгореться
возгораться	возгореться
самовозгораться	самовозгореться
засматриваться	засмотреться
всматриваться	всмотреться
присматриваться	присмотреться
осматриваться	осмотреться
разлетаться	разлететься
слетаться	слететься
переверчиваться	перевертеться
разверчиваться	развертеться
разлезаться	разлезться
вгрызаться	вгрызться
прогрызаться	прогрызться
отгрызаться	отгрызться
задраиваться	задраиться
затаиваться	затаиться
забиваться	забиться
ослабляться	ослабиться
расслабляться	расслабиться
набиваться	набиться
оббиваться	оббиться
подбиваться	подбиться
перебиваться	перебиться
разбиваться	разбиться
взбиваться	взбиться
избиваться	избиться
прибиваться	прибиться
зашибаться	зашибиться
ошибаться	ошибиться
сшибаться	сшибиться
расшибаться	расшибиться
ушибаться	ушибиться
обиваться	обиться
добиваться	добиться
сподобляться	сподобиться
уподобляться	уподобиться
озлобляться	озлобиться
раздробляться	раздробиться
пробиваться	пробиться
обособляться	обособиться
приспосабливаться	приспособиться
ущербляться	ущербиться
оскорбляться	оскорбиться
сбиваться	сбиться
отбиваться	отбиться
убиваться	убиться
усугубляться	усугубиться
усугубляться	усугубиться
углубляться	углубиться
зарубаться	зарубиться
врубаться	врубиться
прорубаться	прорубиться
вырубаться	вырубиться
выбиваться	выбиться
влюбляться	влюбиться
слюбляться	слюбиться
подбавляться	подбавиться
разбавляться	разбавиться
избавляться	избавиться
прибавляться	прибавиться
добавляться	добавиться
сбавляться	сбавиться
убавляться	убавиться
окровавливаться	окровавиться
вдавливаться	вдавиться
продавливаться	продавиться
выдавливаться	выдавиться
завиваться	завиться
переплавляться	переплавиться
оплавляться	оплавиться
сплавляться	сплавиться
расплавляться	расплавиться
выплавляться	выплавиться
ославляться	ославиться
прославляться	прославиться
расславляться	расславиться
навиваться	навиться
заправляться	заправиться
дозаправляться	дозаправиться
направляться	направиться
вправляться	вправиться
переправляться	переправиться
оправляться	оправиться
поправляться	поправиться
справляться	справиться
расправляться	расправиться
исправляться	исправиться
отправляться	отправиться
управляться	управиться
выправляться	выправиться
втравливаться	втравиться
отравляться	отравиться
растравливаться	растравиться
вытравливаться	вытравиться
наставляться	наставиться
обставляться	обставиться
вставляться	вставиться
представляться	представиться
составляться	составиться
расставляться	расставиться
уставляться	уставиться
выставляться	выставиться
обвиваться	обвиться
подвиваться	подвиться
перевиваться	перевиться
удешевляться	удешевиться
одушевляться	одушевиться
воодушевляться	воодушевиться
развиваться	развиться
взвиваться	взвиться
отрезвляться	отрезвиться
протрезвляться	протрезвиться
вытрезвляться	вытрезвиться
извиваться	извиться
удивляться	удивиться
приживляться	приживиться
оживляться	оживиться
перекривляться	перекривиться
искривляться	искривиться
прививаться	привиться
умилостивляться	умилостивиться
овиваться	овиться
довиваться	довиться
благословляться	благословиться
уславливаться	условиться
останавливаться	остановиться
приостанавливаться	приостановиться
расстанавливаться	расстановиться
восстанавливаться	восстановиться
устанавливаться	установиться
обновляться	обновиться
возобновляться	возобновиться
подновляться	подновиться
вдохновляться	вдохновиться
обескровливаться	обескровиться
оздоровляться	оздоровиться
приноравливаться	приноровиться
подготавливаться	подготовиться
переподготавливаться	переподготовиться
изготовляться	изготовиться
приготавливаться	приготовиться
свиваться	свиться
разветвляться	разветвиться
ответвляться	ответвиться
отождествляться	отождествиться
отожествляться	отожествиться
обобществляться	обобществиться
овеществляться	овеществиться
пресуществляться	пресуществиться
осуществляться	осуществиться
увиваться	увиться
являться	явиться
заявляться	заявиться
появляться	появиться
проявляться	проявиться
издырявливаться	издырявиться
продырявливаться	продырявиться
объявляться	объявиться
выявляться	выявиться
отваживаться	отвадиться
обгаживаться	обгадиться
изгаживаться	изгадиться
налаживаться	наладиться
облаживаться	обладиться
заглаживаться	загладиться
разглаживаться	разгладиться
изглаживаться	изгладиться
приглаживаться	пригладиться
проглаживаться	прогладиться
сглаживаться	сгладиться
отглаживаться	отгладиться
выглаживаться	выгладиться
подлаживаться	подладиться
разлаживаться	разладиться
прилаживаться	приладиться
слаживаться	сладиться
наслаждаться	насладиться
услаждаться	усладиться
улаживаться	уладиться
охлаждаться	охладиться
переохлаждаться	переохладиться
прохлаждаться	прохладиться
напомаживаться	напомадиться
ограждаться	оградиться
надсаживаться	надсадиться
высаживаться	высадиться
снабжаться	снабдиться
убеждаться	убедиться
переубеждаться	переубедиться
разубеждаться	разубедиться
повреждаться	повредиться
разрежаться	разредиться
учреждаться	учредиться
нацеживаться	нацедиться
подцеживаться	подцедиться
отцеживаться	отцедиться
уцеживаться	уцедиться
выцеживаться	выцедиться
проезживаться	проездиться
уезживаться	уездиться
объезжаться	объездиться
изъезживаться	изъездиться
нагромождаться	нагромоздиться
взгромождаться	взгромоздиться
разжижаться	разжидиться
сжижаться	сжидиться
освобождаться	освободиться
высвобождаться	высвободиться
обезвоживаться	обезводиться
пригождаться	пригодиться
подмолаживаться	подмолодиться
омолаживаться	омолодиться
выхолаживаться	выхолодиться
распложаться	расплодиться
*	родиться
зарождаться	зародиться
нарождаться	народиться
перерождаться	переродиться
возрождаться	возродиться
загораживаться	загородиться
облагораживаться	облагородиться
обгораживаться	обгородиться
перегораживаться	перегородиться
разгораживаться	разгородиться
огораживаться	огородиться
отгораживаться	отгородиться
выгораживаться	выгородиться
урождаться	уродиться
вырождаться	выродиться
подтверждаться	подтвердиться
утверждаться	утвердиться
возбуждаться	возбудиться
пробуждаться	пробудиться
пробуждаться	пробудиться
запруживаться	запрудиться
натруживаться	натрудиться
застуживаться	застудиться
простуживаться	простудиться
выстуживаться	выстудиться
устыжаться	устыдиться
заряжаться	зарядиться
подзаряжаться	подзарядиться
перезаряжаться	перезарядиться
наряжаться	нарядиться
принаряжаться	принарядиться
снаряжаться	снарядиться
обряжаться	обрядиться
подряжаться	подрядиться
переряживаться	перерядиться
разряжаться	разрядиться
разряжаться	разрядиться
распоряжаться	распорядиться
сряжаться	срядиться
уряжаться	урядиться
выряжаться	вырядиться
заклеиваться	заклеиться
наклеиваться	наклеиться
вклеиваться	вклеиться
приклеиваться	приклеиться
склеиваться	склеиться
расклеиваться	расклеиться
отклеиваться	отклеиться
уклеиваться	уклеиться
выклеиваться	выклеиться
оевропеиваться	оевропеиться
отваживаться	отважиться
заживаться	зажиться
увлажаться	увлажиться
наживаться	нажиться
обнажаться	обнажиться
раздражаться	раздражиться
взбудораживаться	взбудоражиться
обживаться	обжиться
вживаться	вжиться
освежаться	освежиться
просвежаться	просвежиться
перемежаться	перемежиться
смежаться	смежиться
разнеживаться	разнежиться
изнеживаться	изнежиться
искореживаться	искорежиться
съеживаться	съежиться
разживаться	разжиться
размозжаться	размозжиться
приживаться	прижиться
уничижаться	уничижиться
одолжаться	одолжиться
продолжаться	продолжиться
растревоживаться	растревожиться
скукоживаться	скукожиться
обкладываться	обложиться
разлагаться	разложиться
раскладываться	разложиться
прикладываться	приложиться
докладываться	доложиться
полагаться	положиться
располагаться	расположиться
складываться	сложиться
отлагаться	отложиться
откладываться	отложиться
укладываться	уложиться
выкладываться	выложиться
размножаться	размножиться
помножаться	помножиться
умножаться	умножиться
приумножаться	приумножиться
створаживаться	створожиться
удорожаться	удорожиться
настораживаться	насторожиться
проживаться	прожиться
изничтожаться	изничтожиться
уничтожаться	уничтожиться
сживаться	сжиться
уживаться	ужиться
подслуживаться	подслужиться
прислуживаться	прислужиться
дослуживаться	дослужиться
выслуживаться	выслужиться
обнаруживаться	обнаружиться
сдружаться	сдружиться
разоружаться	разоружиться
вооружаться	вооружиться
перевооружаться	перевооружиться
довооружаться	довооружиться
напруживаться	напружиться
удосуживаться	удосужиться
натуживаться	натужиться
поднатуживаться	поднатужиться
напыживаться	напыжиться
заутюживаться	заутюжиться
разутюживаться	разутюжиться
искажаться	исказиться
заражаться	заразиться
преображаться	преобразиться
обезображиваться	обезобразиться
изображаться	изобразиться
воображаться	вообразиться
соображаться	сообразиться
отображаться	отобразиться
разражаться	разразиться
поражаться	поразиться
сражаться	сразиться
отражаться	отразиться
выражаться	выразиться
самовыражаться	самовыразиться
обуржуазиваться	обуржуазиться
приближаться	приблизиться
сближаться	сблизиться
обремизиваться	обремизиться
понижаться	понизиться
снижаться	снизиться
унижаться	унизиться
вонзаться	вонзиться
пронзаться	пронзиться
затормаживаться	затормозиться
обмораживаться	обморозиться
вымораживаться	выморозиться
загружаться	загрузиться
нагружаться	нагрузиться
перегружаться	перегрузиться
разгружаться	разгрузиться
догружаться	догрузиться
погружаться	погрузиться
погружаться	погрузиться
сгружаться	сгрузиться
отгружаться	отгрузиться
выгружаться	выгрузиться
водружаться	водрузиться
суживаться	сузиться
офранцуживаться	офранцузиться
закабаляться	закабалиться
раскабаляться	раскабалиться
заваливаться	завалиться
наваливаться	навалиться
обваливаться	обвалиться
вваливаться	ввалиться
подваливаться	подвалиться
переваливаться	перевалиться
разваливаться	развалиться
приваливаться	привалиться
доваливаться	довалиться
проваливаться	провалиться
сваливаться	свалиться
отваливаться	отвалиться
расхваливаться	расхвалиться
вываливаться	вывалиться
отдаляться	отдалиться
удаляться	удалиться
заливаться	залиться
закаливаться	закалиться
закаливаться	закалиться
накаливаться	накалиться
перекаливаться	перекалиться
докаливаться	докалиться
прокаливаться	прокалиться
раскаляться	раскалиться
оскаливаться	оскалиться
умаляться	умалиться
накрахмаливаться	накрахмалиться
подкрахмаливаться	подкрахмалиться
прокрахмаливаться	прокрахмалиться
наливаться	налиться
запаливаться	запалиться
опаливаться	опалиться
настропаляться	настропалиться
распаляться	распалиться
воспаляться	воспалиться
засаливаться	засалиться
обсаливаться	обсалиться
просаливаться	просалиться
иссаливаться	иссалиться
усаливаться	усалиться
высаливаться	высалиться
подчаливаться	подчалиться
размочаливаться	размочалиться
измочаливаться	измочалиться
счаливаться	счалиться
отчаливаться	отчалиться
обливаться	облиться
доскабливаться	доскоблиться
соскабливаться	соскоблиться
отскабливаться	отскоблиться
выскабливаться	выскоблиться
вливаться	влиться
обугливаться	обуглиться
закругляться	закруглиться
округляться	округлиться
скругляться	скруглиться
замедляться	замедлиться
умедляться	умедлиться
подливаться	подлиться
остебеляться	остебелиться
обеляться	обелиться
пробеливаться	пробелиться
выбеливаться	выбелиться
расшевеливаться	расшевелиться
переделяться	переделиться
определяться	определиться
предопределяться	предопределиться
самоопределяться	самоопределиться
распределяться	распределиться
перераспределяться	перераспределиться
разделяться	разделиться
отделяться	отделиться
выделяться	выделиться
утяжеляться	утяжелиться
осмеливаться	осмелиться
похмеляться	похмелиться
опохмеляться	опохмелиться
испепеляться	испепелиться
переливаться	перелиться
застреливаться	застрелиться
заселяться	заселиться
населяться	населиться
вселяться	вселиться
подселяться	подселиться
развеселяться	развеселиться
взвеселяться	взвеселиться
возвеселяться	возвеселиться
переселяться	переселиться
приселяться	приселиться
поселяться	поселиться
сселяться	сселиться
расселяться	расселиться
отселяться	отселиться
выселяться	выселиться
отеляться	отелиться
растеливаться	растелиться
постилаться	постелиться
расстилаться	расстелиться
устилаться	устелиться
нацеливаться	нацелиться
прицеливаться	прицелиться
исцеляться	исцелиться
раскошеливаться	раскошелиться
разливаться	разлиться
изливаться	излиться
заиливаться	заилиться
нажиливаться	нажилиться
умиляться	умилиться
испиливаться	испилиться
зашпиливаться	зашпилиться
отшпиливаться	отшпилиться
приливаться	прилиться
усиливаться	усилиться
зацикливаться	зациклиться
окукливаться	окуклиться
заземляться	заземлиться
приземляться	приземлиться
увольняться	уволиться
заголяться	заголиться
оголяться	оголиться
доливаться	долиться
взмаливаться	взмолиться
засмаливаться	засмолиться
пересмаливаться	пересмолиться
просмаливаться	просмолиться
высмаливаться	высмолиться
отмаливаться	отмолиться
поливаться	политься
проливаться	пролиться
засаливаться	засолиться
подсаливаться	подсолиться
досаливаться	досолиться
просаливаться	просолиться
усаливаться	усолиться
замусоливаться	замусолиться
обмусоливаться	обмусолиться
измусоливаться	измусолиться
засусоливаться	засусолиться
высаливаться	высолиться
утоляться	утолиться
утепляться	утеплиться
рассверливаться	рассверлиться
иссверливаться	иссверлиться
высверливаться	высверлиться
сливаться	слиться
замасливаться	замаслиться
обмасливаться	обмаслиться
перемасливаться	перемаслиться
измасливаться	измаслиться
промасливаться	промаслиться
умасливаться	умаслиться
окисляться	окислиться
окисляться	окислиться
зачисляться	зачислиться
перечисляться	перечислиться
отчисляться	отчислиться
замусливаться	замуслиться
обмусливаться	обмуслиться
измусливаться	измуслиться
обессмысливаться	обессмыслиться
осветляться	осветлиться
просветляться	просветлиться
отливаться	отлиться
растлеваться	растлиться
уливаться	улиться
обмишуливаться	обмишулиться
нахохливаться	нахохлиться
подрыхляться	подрыхлиться
разрыхляться	разрыхлиться
опошляться	опошлиться
выливаться	вылиться
намыливаться	намылиться
обмыливаться	обмылиться
взмыливаться	взмылиться
измыливаться	измылиться
вымыливаться	вымылиться
опыляться	опылиться
распыляться	распылиться
окрыляться	окрылиться
завяливаться	завялиться
обвяливаться	обвялиться
провяливаться	провялиться
вывяливаться	вывялиться
напяливаться	напялиться
впяливаться	впялиться
выпяливаться	выпялиться
посрамляться	посрамиться
устремляться	устремиться
ущемляться	ущемиться
окаймляться	окаймиться
осведомляться	осведомиться
раззнакомливаться	раззнакомиться
ознакомляться	ознакомиться
обламываться	обломиться
вламываться	вломиться
надламываться	надломиться
подламываться	подломиться
переламываться	переломиться
преломляться	преломиться
разламываться	разломиться
проламываться	проломиться
сламываться	сломиться
отламываться	отломиться
выламываться	выломиться
притомляться	притомиться
истомляться	истомиться
утомляться	утомиться
переутомляться	переутомиться
подкармливаться	подкормиться
прикармливаться	прикормиться
прокармливаться	прокормиться
откармливаться	откормиться
выкармливаться	выкормиться
оформляться	оформиться
затмеваться	затмиться
образумливаться	образумиться
изумляться	изумиться
распрямляться	распрямиться
испрямляться	испрямиться
выпрямляться	выпрямиться
оболваниваться	оболваниться
опоганиваться	опоганиться
испоганиваться	испоганиться
одурманиваться	одурманиться
затуманиваться	затуманиться
притуманиваться	притуманиться
отуманиваться	отуманиться
распространяться	распространиться
отстраняться	отстраниться
устраняться	устраниться
самоустраняться	самоустраниться
предохраняться	предохраниться
сохраняться	сохраниться
приосаниваться	приосаниться
обмещаниваться	обмещаниться
омещаниваться	омещаниться
прибедняться	прибедниться
упраздняться	упраздниться
припоздняться	припоздниться
наводняться	наводниться
приводняться	приводниться
затрудняться	затрудниться
остервеняться	остервениться
оказениваться	оказениться
облениваться	облениться
озеленяться	озелениться
разлениваться	разлениться
излениваться	излениться
пленяться	плениться
сочленяться	сочлениться
расчленяться	расчлениться
заменяться	замениться
воспламеняться	воспламениться
самовоспламеняться	самовоспламениться
обмениваться	обмениться
вменяться	вмениться
обременяться	обремениться
осовремениваться	осовремениться
переменяться	перемениться
обсеменяться	обсемениться
изменяться	измениться
видоизменяться	видоизмениться
применяться	примениться
сменяться	смениться
отменяться	отмениться
остепеняться	остепениться
вспениваться	вспениться
накреняться	накрениться
вкореняться	вкорениться
искореняться	искорениться
укореняться	укорениться
осеняться	осениться
прицениваться	прицениться
обесцениваться	обесцениться
подбочениваться	подбочениться
избочениваться	избочениться
увлажняться	увлажниться
переувлажняться	переувлажниться
испражняться	испражниться
осложняться	осложниться
усложняться	усложниться
опорожняться	опорожниться
опорожняться	опорожниться
соблазняться	соблазниться
разрозниваться	разрозниться
загрязняться	загрязниться
изгрязняться	изгрязниться
извиняться	извиниться
соединяться	соединиться
присоединяться	присоединиться
воссоединяться	воссоединиться
отсоединяться	отсоединиться
уединяться	уединиться
объединяться	объединиться
разъединяться	разъединиться
отъединяться	отъединиться
напружиниваться	напружиниться
прорезиниваться	прорезиниться
удлиняться	удлиниться
заклиниваться	заклиниться
заклиниваться	заклиниться
вклиниваться	вклиниться
вклиниваться	вклиниться
расклиниваться	расклиниться
расклиниваться	расклиниться
выклиниваться	выклиниться
засиниваться	засиниться
подсиниваться	подсиниться
пересиниваться	пересиниться
ощетиниваться	ощетиниться
обчиниваться	обчиниться
подчиняться	подчиниться
починяться	починиться
учиняться	учиниться
заполняться	заполниться
наполняться	наполниться
переполняться	переполниться
дополняться	дополниться
пополняться	пополниться
исполняться	исполниться
преисполняться	преисполниться
восполняться	восполниться
выполняться	выполниться
затемняться	затемниться
утемняться	утемниться
запоминаться	запомниться
припоминаться	припомниться
опоминаться	опомниться
вспоминаться	вспомниться
раззваниваться	раззвониться
дозваниваться	дозвониться
созваниваться	созвониться
наклоняться	наклониться
преклоняться	преклониться
приклоняться	приклониться
склоняться	склониться
отклоняться	отклониться
уклоняться	уклониться
заслоняться	заслониться
прислоняться	прислониться
отслоняться	отслониться
угомоняться	угомониться
засупониваться	засупониться
рассупониваться	рассупониться
обороняться	оборониться
прифасониваться	прифасониться
утоняться	утониться
укрупняться	укрупниться
разукрупняться	разукрупниться
оскверняться	оскверниться
подчерняться	подчерниться
опресняться	опресниться
стесняться	стесниться
оттесняться	оттесниться
утесняться	утесниться
вытисняться	вытисниться
залосниваться	залосниться
проясниваться	проясниться
проясняться	проясниться
уясняться	уясниться
объясняться	объясниться
разъясниваться	разъясниться
разъясняться	разъясниться
изъясняться	изъясниться
выясняться	выясниться
уплотняться	уплотниться
самоуплотняться	самоуплотниться
прилуняться	прилуниться
уточняться	уточниться
утучняться	утучниться
одомашниваться	одомашниться
пригорюниваться	пригорюниться
зарумяниваться	зарумяниться
нарумяниваться	нарумяниться
подрумяниваться	подрумяниться
разрумяниваться	разрумяниться
раздваиваться	раздвоиться
сдваиваться	сдвоиться
сдваиваться	сдвоиться
удваиваться	удвоиться
осваиваться	освоиться
раздаиваться	раздоиться
издаиваться	издоиться
отдаиваться	отдоиться
успокаиваться	успокоиться
самоуспокаиваться	самоуспокоиться
упокоеваться	упокоиться
наслаиваться	наслоиться
переслаиваться	переслоиться
прослаиваться	прослоиться
расслаиваться	расслоиться
отслаиваться	отслоиться
загнаиваться	загноиться
нагнаиваться	нагноиться
выкраиваться	выкроиться
застраиваться	застроиться
настраиваться	настроиться
обстраиваться	обстроиться
встраиваться	встроиться
подстраиваться	подстроиться
перестраиваться	перестроиться
пристраиваться	пристроиться
достраиваться	достроиться
расстраиваться	расстроиться
отстраиваться	отстроиться
устраиваться	устроиться
благоустраиваться	благоустроиться
трудоустраиваться	трудоустроиться
выстраиваться	выстроиться
утраиваться	утроиться
удостаиваться	удостоиться
напиваться	напиться
вкрапливаться	вкрапиться
впиваться	впиться
залепляться	залепиться
налепляться	налепиться
облепляться	облепиться
влепляться	влепиться
разлепляться	разлепиться
прилепляться	прилепиться
слепляться	слепиться
ослепляться	ослепиться
отлепляться	отлепиться
улепляться	улепиться
вылепляться	вылепиться
перепиваться	перепиться
закрепляться	закрепиться
подкрепляться	подкрепиться
прикрепляться	прикрепиться
скрепляться	скрепиться
раскрепляться	раскрепиться
открепляться	открепиться
укрепляться	укрепиться
зацепляться	зацепиться
нацепляться	нацепиться
вцепляться	вцепиться
подцепляться	подцепиться
прицепляться	прицепиться
сцепляться	сцепиться
расцепляться	расцепиться
отцепляться	отцепиться
уцепляться	уцепиться
расщепляться	расщепиться
отщепляться	отщепиться
опиваться	опиться
допиваться	допиться
накапливаться	накопиться
скапливаться	скопиться
окропляться	окропиться
пропиваться	пропиться
затапливаться	затопиться
затопляться	затопиться
перетапливаться	перетопиться
протапливаться	протопиться
стапливаться	стопиться
растапливаться	растопиться
истапливаться	истопиться
оттапливаться	оттопиться
утапливаться	утопиться
вытапливаться	вытопиться
спиваться	спиться
упиваться	упиться
окупаться	окупиться
совокупляться	совокупиться
присовокупляться	присовокупиться
самоокупаться	самоокупиться
искупаться	искупиться
откупаться	откупиться
выкупаться	выкупиться
залупляться	залупиться
облупливаться	облупиться
слупливаться	слупиться
вылупливаться	вылупиться
насупливаться	насупиться
затупляться	затупиться
притупляться	притупиться
потупляться	потупиться
заступаться	заступиться
вступаться	вступиться
подступаться	подступиться
приступаться	приступиться
оступаться	оступиться
поступаться	поступиться
расступаться	расступиться
отступаться	отступиться
завариваться	завариться
обвариваться	обвариться
подвариваться	подвариться
перевариваться	перевариться
развариваться	развариться
привариваться	привариться
довариваться	довариться
недовариваться	недовариться
провариваться	провариться
затовариваться	затовариться
отовариваться	отовариться
свариваться	свариться
отвариваться	отвариться
увариваться	увариться
вывариваться	вывариться
раскочегариваться	раскочегариться
отдариваться	отдариться
ударяться	удариться
зажариваться	зажариться
нажариваться	нажариться
обжариваться	обжариться
поджариваться	поджариться
пережариваться	пережариться
дожариваться	дожариться
недожариваться	недожариться
прожариваться	прожариться
ужариваться	ужариться
выжариваться	выжариться
озаряться	озариться
запариваться	запариться
напариваться	напариться
перепариваться	перепариться
допариваться	допариться
пропариваться	пропариться
спариваться	спариться
распариваться	распариться
испаряться	испариться
отпариваться	отпариться
упариваться	упариться
ошпариваться	ошпариться
выпариваться	выпариться
засахариваться	засахариться
обсахариваться	обсахариться
воцаряться	воцариться
нафабриваться	нафабриться
прифабриваться	прифабриться
подбриваться	подбриться
перебриваться	перебриться
обриваться	обриться
добриваться	добриться
пробриваться	пробриться
отбриваться	отбриться
зазубриваться	зазубриться
иззубриваться	иззубриться
выбриваться	выбриться
обагряться	обагриться
разведриваться	разведриться
внедряться	внедриться
расщедриваться	расщедриться
выпендриваться	выпендриться
подбодряться	подбодриться
взбадриваться	взбодриться
ободряться	ободриться
приободряться	приободриться
умудряться	умудриться
запудриваться	запудриться
напудриваться	напудриться
припудриваться	припудриться
вверяться	ввериться
извериваться	извериться
доверяться	довериться
проверяться	провериться
удостоверяться	удостовериться
сверяться	свериться
учетверяться	учетвериться
уверяться	увериться
разуверяться	разувериться
вознамериваться	вознамериться
обмериваться	обмериться
усемеряться	усемериться
примериваться	примериться
умеряться	умериться
вперяться	впериться
оперяться	опериться
ушестеряться	ушестериться
удевятеряться	удевятериться
упятеряться	упятериться
удесятеряться	удесятериться
ощериваться	ощериться
обезжириваться	обезжириться
растранжириваться	растранжириться
прожириваться	прожириться
замиряться	замириться
примиряться	примириться
утихомириваться	утихомириться
смиряться	смириться
усмиряться	усмириться
умиряться	умириться
расширяться	расшириться
уширяться	ушириться
водворяться	водвориться
заговариваться	заговориться
подговариваться	подговориться
оговариваться	оговориться
договариваться	договориться
проговариваться	проговориться
сговариваться	сговориться
отговариваться	отговориться
уговариваться	уговориться
выговариваться	выговориться
затворяться	затвориться
удовлетворяться	удовлетвориться
претворяться	претвориться
притворяться	притвориться
притворяться	притвориться
отворяться	отвориться
ублаготворяться	ублаготвориться
оплодотворяться	оплодотвориться
приотворяться	приотвориться
умиротворяться	умиротвориться
одухотворяться	одухотвориться
створяться	створиться
растворяться	раствориться
растворяться	раствориться
раззадориваться	раззадориться
разоряться	разориться
покоряться	покориться
ускоряться	ускориться
размариваться	размориться
застопориваться	застопориться
закупориваться	закупориться
раскупориваться	раскупориться
откупориваться	откупориться
засоряться	засориться
рассориваться	рассориться
замусориваться	замусориться
повторяться	повториться
зашториваться	зашториться
обветриваться	обветриться
проветриваться	проветриться
выветриваться	выветриться
исхитряться	исхитриться
ухитряться	ухитриться
заостряться	заостриться
обостряться	обостриться
убыстряться	убыстриться
забуриваться	забуриться
накуриваться	накуриться
обкуриваться	обкуриться
докуриваться	докуриться
прокуриваться	прокуриться
раскуриваться	раскуриться
искуриваться	искуриться
выкуриваться	выкуриться
зажмуриваться	зажмуриться
нахмуриваться	нахмуриться
изнуряться	изнуриться
понуриваться	понуриться
окультуриваться	окультуриться
обмишуриваться	обмишуриться
прищуриваться	прищуриться
сощуриваться	сощуриться
изощряться	изощриться
вспузыриваться	вспузыриться
вспузыриваться	вспузыриться
растопыриваться	растопыриться
оттопыриваться	оттопыриться
отбояриваться	отбояриться
разъяряться	разъяриться
заквашиваться	закваситься
подквашиваться	подкваситься
переквашиваться	перекваситься
доквашиваться	докваситься
проквашиваться	прокваситься
сквашиваться	скваситься
оглашаться	огласиться
соглашаться	согласиться
закрашиваться	закраситься
накрашиваться	накраситься
обкрашиваться	обкраситься
подкрашиваться	подкраситься
перекрашиваться	перекраситься
окрашиваться	окраситься
прокрашиваться	прокраситься
скрашиваться	скраситься
раскрашиваться	раскраситься
искрашиваться	искраситься
украшаться	украситься
разукрашиваться	разукраситься
изукрашиваться	изукраситься
приукрашиваться	приукраситься
выкрашиваться	выкраситься
завешиваться	завеситься
занавешиваться	занавеситься
обвешиваться	обвеситься
подвешиваться	подвеситься
перевешиваться	перевеситься
развешиваться	развеситься
взвешиваться	взвеситься
привешиваться	привеситься
уравновешиваться	уравновеситься
провешиваться	провеситься
свешиваться	свеситься
замешиваться	замеситься
перемешиваться	перемеситься
размешиваться	размеситься
промешиваться	промеситься
смешиваться	смеситься
вымешиваться	вымеситься
обкашиваться	обкоситься
вкашиваться	вкоситься
подкашиваться	подкоситься
перекашиваться	перекоситься
скашиваться	скоситься
раскашиваться	раскоситься
искашиваться	искоситься
искашиваться	искоситься
выкашиваться	выкоситься
занашиваться	заноситься
обнашиваться	обноситься
поднашиваться	подноситься
разнашиваться	разноситься
изнашиваться	износиться
донашиваться	доноситься
пронашиваться	проноситься
снашиваться	сноситься
вынашиваться	выноситься
бросаться	броситься
набрасываться	наброситься
перебрасываться	переброситься
пробрасываться	проброситься
сбрасываться	сброситься
выбрасываться	выброситься
орошаться	ороситься
напрашиваться	напроситься
перепрашиваться	перепроситься
допрашиваться	допроситься
спрашиваться	спроситься
отпрашиваться	отпроситься
выпрашиваться	выпроситься
покушаться	покуситься
искушаться	искуситься
натрушиваться	натруситься
перетрушиваться	перетруситься
струшиваться	струситься
раструшиваться	раструситься
вытрушиваться	вытруситься
возвышаться	возвыситься
превозвышаться	превозвыситься
повышаться	повыситься
хвататься	хватиться
подхватываться	подхватиться
спохватываться	спохватиться
схватываться	схватиться
ухватываться	ухватиться
обогащаться	обогатиться
закатываться	закатиться
накатываться	накатиться
обкатываться	обкатиться
вкатываться	вкатиться
подкатываться	подкатиться
перекатываться	перекатиться
прикатываться	прикатиться
окатываться	окатиться
докатываться	докатиться
прокатываться	прокатиться
скатываться	скатиться
скатываться	скатиться
раскатываться	раскатиться
откатываться	откатиться
укатываться	укатиться
выкатываться	выкатиться
расплачиваться	расплатиться
раскосмачиваться	раскосматиться
разлохмачиваться	разлохматиться
взлохмачиваться	взлохматиться
обращаться	обратиться
превращаться	превратиться
развращаться	развратиться
извращаться	извратиться
возвращаться	возвратиться
совращаться	совратиться
прекращаться	прекратиться
обюрокрачиваться	обюрократиться
сокращаться	сократиться
растрачиваться	растратиться
истрачиваться	истратиться
утрачиваться	утратиться
засвечиваться	засветиться
освещаться	осветиться
просвещаться	просветиться
просвечиваться	просветиться
расцвечиваться	расцветиться
обесцвечиваться	обесцветиться
намечаться	наметиться
отмечаться	отметиться
засекречиваться	засекретиться
рассекречиваться	рассекретиться
встречаться	встретиться
обрешечиваться	обрешетиться
изрешечиваться	изрешетиться
намагничиваться	намагнититься
размагничиваться	размагнититься
восхищаться	восхититься
защищаться	защититься
завинчиваться	завинтиться
навинчиваться	навинтиться
ввинчиваться	ввинтиться
развинчиваться	развинтиться
взвинчиваться	взвинтиться
извинчиваться	извинтиться
привинчиваться	привинтиться
свинчиваться	свинтиться
отвинчиваться	отвинтиться
вывинчиваться	вывинтиться
озабочиваться	озаботиться
порабощаться	поработиться
отягощаться	отяготиться
облокачиваться	облокотиться
поглощаться	поглотиться
заболачиваться	заболотиться
обколачиваться	обколотиться
сколачиваться	сколотиться
расколачиваться	расколотиться
исколачиваться	исколотиться
размолачиваться	размолотиться
измолачиваться	измолотиться
воплощаться	воплотиться
перевоплощаться	перевоплотиться
сплачиваться	сплотиться
укрощаться	укротиться
оборачиваться	оборотиться
заворачиваться	заворотиться
подворачиваться	подворотиться
переворачиваться	переворотиться
поворачиваться	поворотиться
сворачиваться	своротиться
отворачиваться	отворотиться
выворачиваться	выворотиться
укорачиваться	укоротиться
разохочиваться	разохотиться
приохочиваться	приохотиться
перекапчиваться	перекоптиться
прокапчиваться	прокоптиться
выкапчиваться	выкоптиться
исчерчиваться	исчертиться
подлащиваться	подластиться
услащаться	усластиться
умащаться	умаститься
пристращаться	пристраститься
причащаться	причаститься
учащаться	участиться
усовещиваться	усовеститься
подлещаться	подлеститься
вмещаться	вместиться
совмещаться	совместиться
перемещаться	переместиться
размещаться	разместиться
возмещаться	возместиться
помещаться	поместиться
смещаться	сместиться
умещаться	уместиться
вымещаться	выместиться
перекрещиваться	перекреститься
скрещиваться	скреститься
открещиваться	откреститься
выкрещиваться	выкреститься
начищаться	начиститься
обчищаться	обчиститься
подчищаться	подчиститься
очищаться	очиститься
счищаться	счиститься
расчищаться	расчиститься
отчищаться	отчиститься
вычищаться	вычиститься
утолщаться	утолститься
угощаться	угоститься
подмащиваться	подмоститься
взмащиваться	взмоститься
примащиваться	примоститься
умащиваться	умоститься
закрепощаться	закрепоститься
раскрепощаться	раскрепоститься
прощаться	проститься
опрощаться	опроститься
упрощаться	упроститься
сгущаться	сгуститься
пускаться	пуститься
напускаться	напуститься
припускаться	припуститься
опускаться	опуститься
спускаться	спуститься
распускаться	распуститься
ниспускаться	ниспуститься
приспускаться	приспуститься
прельщаться	прельститься
обольщаться	обольститься
подольщаться	подольститься
возмущаться	возмутиться
смущаться	смутиться
закручиваться	закрутиться
накручиваться	накрутиться
обкручиваться	обкрутиться
вкручиваться	вкрутиться
подкручиваться	подкрутиться
перекручиваться	перекрутиться
окручиваться	окрутиться
докручиваться	докрутиться
прокручиваться	прокрутиться
скручиваться	скрутиться
раскручиваться	раскрутиться
искручиваться	искрутиться
откручиваться	открутиться
укручиваться	укрутиться
выкручиваться	выкрутиться
отшучиваться	отшутиться
насыщаться	насытиться
перенасыщаться	перенасытиться
пересыщаться	пересытиться
пресыщаться	пресытиться
посвящаться	посвятиться
впячиваться	впятиться
отпячиваться	отпятиться
выпячиваться	выпятиться
насобачиваться	насобачиться
озадачиваться	озадачиться
облачаться	облачиться
разоблачаться	разоблачиться
саморазоблачаться	саморазоблачиться
означаться	означиться
обозначаться	обозначиться
омрачаться	омрачиться
помрачаться	помрачиться
изловчаться	изловчиться
облегчаться	облегчиться
размягчаться	размягчиться
смягчаться	смягчиться
умягчаться	умягчиться
отягчаться	отягчиться
увековечиваться	увековечиться
очеловечиваться	очеловечиться
вочеловечиваться	вочеловечиться
изувечиваться	изувечиться
залечиваться	залечиться
искалечиваться	искалечиться
подлечиваться	подлечиться
перелечиваться	перелечиться
излечиваться	излечиться
долечиваться	долечиться
недолечиваться	недолечиться
вылечиваться	вылечиться
онемечиваться	онемечиться
обеспечиваться	обеспечиться
отуречиваться	отуречиться
возвеличиваться	возвеличиться
увеличиваться	увеличиться
обезличиваться	обезличиться
отличаться	отличиться
разграничиваться	разграничиться
ограничиваться	ограничиться
отграничиваться	отграничиться
ополчаться	ополчиться
кончаться	кончиться
заканчиваться	закончиться
приканчиваться	прикончиться
оканчиваться	окончиться
доканчиваться	докончиться
истончаться	истончиться
утончаться	утончиться
орабочиваться	орабочиться
упорядочиваться	упорядочиться
всклокочиваться	всклокочиться
выщелачиваться	выщелочиться
всклочиваться	всклочиться
переволакиваться	переволочиться
приволакиваться	приволочиться
доволакиваться	доволочиться
отволакиваться	отволочиться
уволакиваться	уволочиться
замачиваться	замочиться
намачиваться	намочиться
обмачиваться	обмочиться
подмачиваться	подмочиться
размачиваться	размочиться
измачиваться	измочиться
вымачиваться	вымочиться
упрочиваться	упрочиться
исстрачиваться	исстрочиться
просачиваться	просочиться
высачиваться	высочиться
затачиваться	заточиться
заточаться	заточиться
сосредоточиваться	сосредоточиться
рассредоточиваться	рассредоточиться
стачиваться	сточиться
растачиваться	расточиться
ожесточаться	ожесточиться
ужесточаться	ужесточиться
истачиваться	источиться
оттачиваться	отточиться
утачиваться	уточиться
вытачиваться	выточиться
проперчиваться	проперчиться
проперчиваться	проперчиться
огорчаться	огорчиться
заучиваться	заучиться
научаться	научиться
обучаться	обучиться
переобучаться	переобучиться
нахлобучиваться	нахлобучиться
подучиваться	подучиться
переучиваться	переучиться
разучиваться	разучиться
приучаться	приучиться
скучиваться	скучиться
облучаться	облучиться
разлучаться	разлучиться
излучаться	излучиться
получаться	получиться
случаться	случиться
отлучаться	отлучиться
замучиваться	замучиться
измучиваться	измучиться
домучиваться	домучиться
отмучиваться	отмучиться
умучиваться	умучиться
доучиваться	доучиться
напучиваться	напучиться
вспучиваться	вспучиться
выпучиваться	выпучиться
заручаться	заручиться
обручаться	обручиться
удручаться	удручиться
приручаться	приручиться
поручаться	поручиться
выручаться	выручиться
засучиваться	засучиться
подсучиваться	подсучиться
ссучиваться	ссучиться
рассучиваться	рассучиться
отсучиваться	отсучиться
высучиваться	высучиться
улетучиваться	улетучиться
отучиваться	отучиться
выучиваться	выучиться
размельчаться	размельчиться
измельчаться	измельчиться
умельчаться	умельчиться
заключаться	заключиться
включаться	включиться
подключаться	подключиться
переключаться	переключиться
приключаться	приключиться
отключаться	отключиться
выключаться	выключиться
скрючиваться	скрючиться
навьючиваться	навьючиться
перевьючиваться	перевьючиться
развьючиваться	развьючиться
ополячиваться	ополячиться
разгорячаться	разгорячиться
раскорячиваться	раскорячиться
зашиваться	зашиться
устрашаться	устрашиться
обшиваться	обшиться
ухудшаться	ухудшиться
спешиваться	спешиться
решаться	решиться
разрешаться	разрешиться
отрешаться	отрешиться
утешаться	утешиться
лишаться	лишиться
утишаться	утишиться
взъерошиваться	взъерошиться
обкрашиваться	обкрошиться
скрашиваться	скрошиться
раскрашиваться	раскрошиться
выкрашиваться	выкрошиться
завершаться	завершиться
довершаться	довершиться
совершаться	совершиться
свершаться	свершиться
расшиваться	расшиться
отшиваться	отшиться
ушиваться	ушиться
заглушаться	заглушиться
вышелушиваться	вышелушиться
опушаться	опушиться
распушаться	распушиться
нарушаться	нарушиться
обрушиваться	обрушиться
разрушаться	разрушиться
засушиваться	засушиться
обсушиваться	обсушиться
подсушиваться	подсушиться
пересушиваться	пересушиться
осушаться	осушиться
досушиваться	досушиться
просушиваться	просушиться
иссушаться	иссушиться
усушаться	усушиться
высушиваться	высушиться
улучшаться	улучшиться
уменьшаться	уменьшиться
уменьшаться	уменьшиться
втемяшиваться	втемяшиться
вытаращиваться	вытаращиться
затаскиваться	затащиться
втаскиваться	втащиться
подтаскиваться	подтащиться
перетаскиваться	перетащиться
притаскиваться	притащиться
дотаскиваться	дотащиться
протаскиваться	протащиться
стаскиваться	стащиться
встаскиваться	встащиться
оттаскиваться	оттащиться
утаскиваться	утащиться
вытаскиваться	вытащиться
обобщаться	обобщиться
разобщаться	разобщиться
приобщаться	приобщиться
сообщаться	сообщиться
вылащиваться	вылощиться
истощаться	истощиться
обмирщаться	обмирщиться
сморщиваться	сморщиться
встопорщиваться	встопорщиться
сплющиваться	сплющиться
расплющиваться	расплющиться
закалываться	заколоться
накалываться	наколоться
обкалываться	обколоться
вкалываться	вколоться
надкалываться	надколоться
прокалываться	проколоться
скалываться	сколоться
раскалываться	расколоться
искалываться	исколоться
откалываться	отколоться
укалываться	уколоться
перемалываться	перемолоться
размалываться	размолоться
измалываться	измолоться
смалываться	смолоться
вымалываться	вымолоться
напарываться	напороться
подпарываться	подпороться
спарываться	спороться
распарываться	распороться
отпарываться	отпороться
выпарываться	выпороться
попадаться	попасться
спадаться	спасться
распадаться	распасться
закрадываться	закрасться
вкрадываться	вкрасться
подкрадываться	подкрасться
прокрадываться	прокрасться
скрадываться	скрасться
выкрадываться	выкрасться
заедаться	заесться
наедаться	наесться
приедаться	приесться
проедаться	проесться
сседаться	ссесться
рассаживаться	рассесться
расседаться	рассесться
усаживаться	усесться
зачитываться	зачесться
рассчитываться	расчесться
объедаться	объесться
въедаться	въесться
разъедаться	разъесться
взъедаться	взъесться
отъедаться	отъесться
обуваться	обуться
переобуваться	переобуться
надуваться	надуться
обдуваться	обдуться
раздуваться	раздуться
вздуваться	вздуться
продуваться	продуться
разуваться	разуться
обманываться	обмануться
захлебываться	захлебнуться
улыбаться	улыбнуться
загибаться	загнуться
нагибаться	нагнуться
перегибаться	перегнуться
застегиваться	застегнуться
пристегиваться	пристегнуться
расстегиваться	расстегнуться
отстегиваться	отстегнуться
воздвигаться	воздвигнуться
перемигиваться	перемигнуться
смигиваться	смигнуться
пригибаться	пригнуться
огибаться	обогнуться
вгибаться	вогнуться
подгибаться	подогнуться
разгибаться	разогнуться
изгибаться	изогнуться
содрогаться	содрогнуться
прогибаться	прогнуться
сгибаться	согнуться
отгибаться	отогнуться
ввергаться	ввергнуться
подвергаться	подвергнуться
извергаться	извергнуться
низвергаться	низвергнуться
повергаться	повергнуться
ниспровергаться	ниспровергнуться
свергаться	свергнуться
вторгаться	вторгнуться
исторгаться	исторгнуться
отторгаться	отторгнуться
выгибаться	выгнуться
отрыгиваться	отрыгнуться
облизываться	облизнуться
разверзаться	разверзнуться
смерзаться	смерзнуться
обрызгиваться	обрызнуться
огрызаться	огрызнуться
оскальзываться	оскользнуться
поскальзываться	поскользнуться
задвигаться	задвинуться
надвигаться	надвинуться
вдвигаться	вдвинуться
передвигаться	передвинуться
раздвигаться	раздвинуться
придвигаться	придвинуться
пододвигаться	пододвинуться
подвигаться	подвинуться
продвигаться	продвинуться
содвигаться	содвинуться
отодвигаться	отодвинуться
сдвигаться	сдвинуться
выдвигаться	выдвинуться
закидываться	закинуться
накидываться	накинуться
перекидываться	перекинуться
прикидываться	прикинуться
запрокидываться	запрокинуться
опрокидываться	опрокинуться
выпрокидываться	выпрокинуться
скидываться	скинуться
раскидываться	раскинуться
вскидываться	вскинуться
откидываться	откинуться
выкидываться	выкинуться
заикаться	заикнуться
перекликаться	перекликнуться
откликаться	откликнуться
проникаться	проникнуться
перехихикиваться	перехихикнуться
защелкиваться	защелкнуться
наталкиваться	натолкнуться
вталкиваться	втолкнуться
проталкиваться	протолкнуться
сталкиваться	столкнуться
отталкиваться	оттолкнуться
замыкаться	замкнуться
размыкаться	разомкнуться
смыкаться	сомкнуться
отмыкаться	отомкнуться
приволакиваться	приволокнуться
отхаркиваться	отхаркнуться
смеркаться	смеркнуться
расчеркиваться	расчеркнуться
отчеркиваться	отчеркнуться
затыкаться	заткнуться
натыкаться	наткнуться
претыкаться	преткнуться
притыкаться	приткнуться
втыкаться	воткнуться
подтыкаться	подоткнуться
спотыкаться	споткнуться
утыкаться	уткнуться
перестукиваться	перестукнуться
обвыкаться	обвыкнуться
свыкаться	свыкнуться
спотыкаться	спотыкнуться
притрагиваться	притронуться
дотрагиваться	дотронуться
страгиваться	стронуться
запинаться	запнуться
разлипаться	разлипнуться
слипаться	слипнуться
защипываться	защипнуться
захлопываться	захлопнуться
зачерпываться	зачерпнуться
обертываться	обернуться
обертываться	обернуться
оборачиваться	обернуться
завертываться	завернуться
завертываться	завернуться
навертываться	навернуться
обвертываться	обвернуться
подвертываться	подвернуться
подвертываться	подвернуться
перевертываться	перевернуться
развертываться	развернуться
изворачиваться	извернуться
привертываться	привернуться
поворачиваться	повернуться
провертываться	провернуться
свертываться	свернуться
отвертываться	отвернуться
отворачиваться	отвернуться
увертываться	увернуться
вывертываться	вывернуться
задергиваться	задернуться
обдергиваться	обдернуться
передергиваться	передернуться
раздергиваться	раздернуться
вздергиваться	вздернуться
одергиваться	одернуться
подергиваться	подернуться
продергиваться	продернуться
отдергиваться	отдернуться
выдергиваться	выдернуться
сковыриваться	сковырнуться
отковыриваться	отковырнуться
перекувыркиваться	перекувырнуться
выкувыркиваться	выкувырнуться
ужасаться	ужаснуться
заплескиваться	заплеснуться
переплескиваться	переплеснуться
всплескиваться	всплеснуться
отплескиваться	отплеснуться
выплескиваться	выплеснуться
скисаться	скиснуться
затискиваться	затиснуться
втискиваться	втиснуться
подтискиваться	подтиснуться
притискиваться	притиснуться
протискиваться	протиснуться
стискиваться	стиснуться
оттискиваться	оттиснуться
вытисняться	вытиснуться
касаться	коснуться
прикасаться	прикоснуться
соприкасаться	соприкоснуться
ополаскиваться	ополоснуться
споласкиваться	сполоснуться
просыпаться	проснуться
опрыскиваться	опрыснуться
спрыскиваться	спрыснуться
сплющиваться	сплюснуться
расплющиваться	расплюснуться
отшатываться	отшатнуться
переметываться	переметнуться
взметываться	взметнуться
выметываться	выметнуться
захлестываться	захлестнуться
перехлестываться	перехлестнуться
схлестываться	схлестнуться
пересвистываться	пересвистнуться
окунаться	окунуться
насовываться	насунуться
всовываться	всунуться
подсовываться	подсунуться
просовываться	просунуться
высовываться	высунуться
замахиваться	замахнуться
обмахиваться	обмахнуться
перемахиваться	перемахнуться
размахиваться	размахнуться
промахиваться	промахнуться
отмахиваться	отмахнуться
запахиваться	запахнуться
распахиваться	распахнуться
отпахиваться	отпахнуться
усмехаться	усмехнуться
свихиваться	свихнуться
впихиваться	впихнуться
пропихиваться	пропихнуться
отпихиваться	отпихнуться
выпихиваться	выпихнуться
задыхаться	задохнуться
выдыхаться	выдохнуться
ссыхаться	ссохнуться
рассыхаться	рассохнуться
вбухиваться	вбухнуться
всколыхиваться	всколыхнуться
отряхиваться	отряхнуться
стряхиваться	стряхнуться
встряхиваться	встряхнуться
вытряхиваться	вытряхнуться
выниматься	вынуться
ухмыляться	ухмыльнуться
наклевываться	наклюнуться
проклевываться	проклюнуться
отплевываться	отплюнуться
переглядываться	переглянуться
оглядываться	оглянуться
откашливаться	откашлянуться
выкашливаться	выкашлянуться
затягиваться	затянуться
натягиваться	натянуться
обтягиваться	обтянуться
втягиваться	втянуться
подтягиваться	подтянуться
перетягиваться	перетянуться
притягиваться	притянуться
дотягиваться	дотянуться
протягиваться	протянуться
стягиваться	стянуться
растягиваться	растянуться
оттягиваться	оттянуться
вытягиваться	вытянуться
забываться	забыться
позабываться	позабыться
избываться	избыться
сбываться	сбыться
сплываться	сплыться
расплываться	расплыться
намываться	намыться
обмываться	обмыться
подмываться	подмыться
перемываться	перемыться
размываться	размыться
омываться	омыться
домываться	домыться
промываться	промыться
смываться	смыться
отмываться	отмыться
умываться	умыться
вымываться	вымыться
зарываться	зарыться
обрываться	обрыться
врываться	врыться
подрываться	подрыться
закрываться	закрыться
накрываться	накрыться
прикрываться	прикрыться
покрываться	покрыться
скрываться	скрыться
раскрываться	раскрыться
вскрываться	вскрыться
открываться	открыться
приоткрываться	приоткрыться
укрываться	укрыться
дорываться	дорыться
прорываться	прорыться
отрываться	отрыться
вырываться	вырыться
закаиваться	закаяться
раскаиваться	раскаяться
отлаиваться	отлаяться
размаиваться	размаяться
смаиваться	смаяться
умаиваться	умаяться
припаиваться	припаяться
спаиваться	спаяться
распаиваться	распаяться
отпаиваться	отпаяться
выпаиваться	выпаяться
отчаиваться	отчаяться
развеиваться	развеяться
взвеваться	взвеяться
провеиваться	провеяться
отвеиваться	отвеяться
вывеиваться	вывеяться
просеиваться	просеяться
рассеиваться	рассеяться
отсеиваться	отсеяться
отсеиваться	отсеяться
усеиваться	усеяться
затеваться	затеяться
обваливаться	обваляться
сваливаться	сваляться
уваливаться	уваляться
вываливаться	вываляться
пристреливаться	пристреляться
отстреливаться	отстреляться
разгуливаться	разгуляться
прогуливаться	прогуляться
отгуливаться	отгуляться
выгуливаться	выгуляться
закашливаться	закашляться
прокашливаться	прокашляться
раскашливаться	раскашляться
откашливаться	откашляться
выкашливаться	выкашляться
заминаться	замяться
обминаться	обмяться
вминаться	вмяться
разминаться	размяться
изминаться	измяться
приминаться	примяться
проминаться	промяться
сминаться	смяться
уминаться	умяться
заниматься	заняться
раскланиваться	раскланяться
откланиваться	откланяться
наниматься	наняться
обниматься	обняться
подравниваться	подравняться
приравниваться	приравняться
сравниваться	сравняться
уравниваться	уравняться
заравниваться	заровняться
обравниваться	обровняться
сравниваться	сровняться
уравниваться	уровняться
выравниваться	выровняться
подниматься	подняться
приподниматься	приподняться
обмениваться	обменяться
размениваться	разменяться
разниматься	разняться
приниматься	приняться
сниматься	сняться
пересниматься	пересняться
отниматься	отняться
униматься	уняться
застаиваться	застояться
настаиваться	настояться
перестаиваться	перестояться
достаиваться	достояться
отстаиваться	отстояться
устаиваться	устояться
выстаиваться	выстояться
затериваться	затеряться
растериваться	растеряться
утериваться	утеряться
отшвыриваться	отшвыряться
зажигаться	зажечься
нажигаться	нажечься
обжигаться	обжечься
пережигаться	пережечься
разжигаться	разжечься
изжигаться	изжечься
возжигаться	возжечься
ожигаться	ожечься
прожигаться	прожечься
сжигаться	сжечься
облекаться	облечься
завлекаться	завлечься
развлекаться	развлечься
извлекаться	извлечься
вовлекаться	вовлечься
совлекаться	совлечься
отвлекаться	отвлечься
увлекаться	увлечься
укладываться	улечься
запекаться	запечься
подпекаться	подпечься
перепекаться	перепечься
припекаться	припечься
допекаться	допечься
пропекаться	пропечься
спекаться	спечься
упекаться	упечься
выпекаться	выпечься
зарекаться	заречься
нарекаться	наречься
обрекаться	обречься
оберегаться	оберечься
сберегаться	сберечься
уберегаться	уберечься
остерегаться	остеречься
отрекаться	отречься
засекаться	засечься
обсекаться	обсечься
пересекаться	пересечься
пресекаться	пресечься
осекаться	осечься
просекаться	просечься
рассекаться	рассечься
иссекаться	иссечься
высекаться	высечься
стекаться	стечься
растекаться	растечься
обстригаться	обстричься
подстригаться	подстричься
перестригаться	перестричься
остригаться	остричься
достригаться	достричься
постригаться	постричься
расстригаться	расстричься
отстригаться	отстричься
заволакиваться	заволочься
обволакиваться	обволочься
переволакиваться	переволочься
приволакиваться	приволочься
доволакиваться	доволочься
отволакиваться	отволочься
уволакиваться	уволочься
разнемогаться	разнемочься
перемогаться	перемочься
запрягаться	запрячься
напрягаться	напрячься
перенапрягаться	перенапрячься
впрягаться	впрячься
подпрягаться	подпрячься
перепрягаться	перепрячься
припрягаться	припрячься
спрягаться	спрячься
распрягаться	распрячься
отпрягаться	отпрячься
выпрягаться	выпрячься
